Mm, Mm, Mm, Mm, Mm, Mm, Mm, Mm, Mm, Mm, Mm, Mm, Mm, Hhd, Hhd, Hhd, Mm, Mm, Mm, Mm, Mm, Mm, Mm, Mm, Mm, Mm, Mm, Mm, Ms, Mm, Mm, Mm, Mm, Hhd, Hhd, Mm, Mm, Mm, Mm, Mm, Ms, Ms, Ms, Mm, Mm, Mm
Mm, Mm, Mm, Mm, Mm, Mm, Aa, Ms, Mm, Mm, Ha, Mm, Mm, Hhd, Ms, Hhd, Mm, Mm, Ms, Mm, Mm, Mm, Mm, Mm, Ms, Ms, Ms, Ms, Ms, Ms, Hhd, Mm, Ha, Mm, Ms, Ms, Ms, Hhd, Hhd, Mm, Ms, Re^Vct, Ha, Ms, Mm, Mm
Mm, Mm, Ms, Ms, Aa, Aa, Mm, Mm, Ms, Mm, Ha, Mm, Mm, Mm, Mm, Ms, Mm, Mm, Ms, Mm, Ms, Ms, Ms, Ms, Mm, Mm, Ms, Aa, Aa, Mm, Hhd, Ha, Mm, Mm, Aa, Ms, Mm, Mm, Mm, Mm, Mm, Cea, Kea, Re^Vct, Mm, Mm
Ms, Ms, Ms, Ha, Hhd, Hhd, Mm, Ms, Ha, Aa, Hhd, Aa, Ms, Mm, Mm, Mm, Mm, Ms, Mm, Mm, Ha, Aa, Ha, Ha, Ms, Mm, Ms, Aa, Mm, Ms, Ms, Aa, Ha, Mm, Aa, Mm, Ha, Ha, Mm, Hhd, Re^Vct, Cea, Cea, Hhd, Mm, Ms
Ms, Ms, Ms, Ha, Hhd, Mm, Ms, Ms, Ha, Hhd, Hhd, Ms, Ms, Mm, Ms, Mm, Ms, Ms, Ha, Ha, Hhd, Aa, Ms, Ms, Mm, Mm, Hhd, Hhd, Mm, Mm, Mm, Mm, Mm, Ms, Mm, Mm, Hhd, Hhd, Mm, Hhd, Mm, Mm, Mm, Re^Vct, Ms, Ms
Mm, Ms, Ms, Aa, Mm, Mm, Ha, Ms, Mm, Ha, Ms, Hhd, Mm, Mm, Ms, Ms, Ms, Ha, Ha, Hhd, Hhd, Hhd, Mm, Ms, Ha, Mm, Aa, Hhd, Aa, Mm, Re, Hhd, Ha, Mm, Mm, Mm, Mm, Hhd, Mm, Mm, Mm, Mm, Ha, Mm, Ms, Ms
Mm, Mm, Ms, Ms, Hhd, Ha, Ha, Hhd, Mm, Aa, Ms, Mm, Aa, Ms, Ms, Ms, Ms, Hhd, Ha, Hhd, Mm, Mm, Mm, Ms, Aa, Aa, Coa, Aa, Coa, Re, Coa, Aa, Aa, Mm, Ms, Ms, Mm, Mm, Mm, Ms, Ms, Ha, Ha, Ha, Mm, Ms
Ms, Ms, Hh, Hh, Hhd, Hhd, Hhd, Hhd, Mm, Ms, Mm, Aa, Aa, Mm, Ms, Ms, Mm, Hhd, Hhd, Ha, Mm, Mm, Re, Re, Coa, Coa, Ha, Coa, Re^Es, Coa, Aa, Coa, Coa, Aa, Re, Mm, Ms, Mm, Ms, Mm, Ms, Hhd, Mm, Mm, Mm, Mm
Ms, Ms, Mm, Mm, Mm, Hh, Mm, Mm, Mm, Mm, Mm, Mm, Mm, Mm, Mm, Ms, Ha, Ms, Mm, Mm, Mm, Mm, Aa, Coa, Aa, Re, Hhd, Hhd, Re^Es, Aa^Voa, Re, Ha, Hhd, Coa, Re, Hhd, Mm, Ms, Mm, Mm, Mm, Ms, Mm, Mm, Ms, Mm
Ms, Ms, Mm, Mm, Mm, Mm, Ms, Mm, Ms, Aa, Ha, Mm, Mm, Mm, Hhd, Ha, Ha, Mm, Mm, Mm, Ms, Re, Coa, Coa, Aa, Re, Hhd^Vo, Hhd, Aa, Re, Re, Hhd, Hhd, Coa, Coa, Aa, Ms, Mm, Mm, Ms, Ms, Mm, Ms, Ms, Ms, Mm
Mm, Mm, Mm, Mm, Mm, Ms, Mm, Mm, Hhd, Hhd, Ha, Re^Vct, Mm, Mm, Mm, Hhd, Mm, Mm, Mm, Ms, Aa, Aa, Coa, Ha, Hhd, Re, Re, Re, Hhd, Re^Es, Aa, Aa^Voa, Re, Ha, Coa, Aa, Aa, Hhd, Mm, Ms, Ha, Ms, Hhd, Ms, Ms, Mm
Mm, Ms, Ms, Mm, Ms, Mm, Ha, Hhd, Hhd, Hh, Hh, Cea, Cea, Mm, Mm, Hhd, Mm, Mm, Mm, Hhd, Re, Coa, Hhd, Hhd, Ha, Hhd, Aa, Coa, Koa, Coa, Re, Re, Re, Aa, Aa, Coa, Aa, Ha, Ms, Ms, Ha, Aa, Hhd, Ms, Ms, Ms
Mm, Ms, Ms, Ms, Ms, Mm, Ha, Ha, Mm, Hh, Ms, Kea, Cea, Re^Vct, Hhd, Mm, Hhd, Mm, Mm, Mm, Re, Coa, Coa, Aa, Re^Voa, Re, Re^Es, Coa, Re, Coa, Re, Aa, Ha, Re^Es, Coa, Coa, Re, Ms, Mm, Ms, Aa, Hhd, Mm, Mm, Mm, Ms
Mm, Ms, Ms, Ms, Ms, Mm, Mm, Mm, Ms, Ms, Ms, Mm, Re^Vct, Mm, Hhd, Ha, Ha, Ha, Mm, Mm, Mm, Aa, Coa, Re, Re^Es, Re, Re, Aa, Aa, Re, Re^Es, Hhd, Hhd, Hhd, Coa, Re, Mm, Mm, Mm, Mm, Ha, Hhd, Ms, Mm, Hhd, Ms
Mm, Ms, Ms, Ms, Mm, Mm, Mm, Mm, Ms, Ms, Mm, Mm, Mm, Mm, Aa, Hhd, Ms, Ha, Aa, Mm, Aa, Re, Re, Coa, Hhd, Hhd, Re, Hhd^Vo, Hhd, Re^Es, Re, Hhd^Voa, Hhd, Coa, Re, Re, Ha, Ha, Mm, Ms, Ms, Mm, Ms, Ha, Ha, Hhd
Mm, Mm, Mm, Mm, Mm, Mm, Mm, Mm, Hhd, Mm, Mm, Mm, Ms, Aa, Aa, Hhd, Hhd, Mm, Mm, Aa, Mm, Hhd, Re, Coa, Coa, Aa, Aa, Hhd, Hhd, Ha, Aa, Aa, Coa, Coa, Aa, Hhd, Mm, Ha, Aa, Ms, Ms, Mm, Mm, Ms, Mm, Hhd
Mm, Mm, Ha, Ha, Hhd, Hhd, Ha, Hh, Hhd, Hhd, Mm, Mm, Ms, Ms, Ms, Hhd, Mm, Ha, Ha, Mm, Mm, Mm, Ms, Re, Aa, Coa, Coa, Coa, Coa, Coa, Coa, Coa, Aa, Aa, Hhd, Mm, Ms, Ms, Ms, Ha, Ha, Mm, Mm, Mm, Mm, Mm
Mm, Mm, Ha, Ha, Hhd, Ha, Ha, Ha, Hh, Hhd, Mm, Mm, Ms, Ms, Ms, Ms, Mm, Mm, Hhd, Mm, Mm, Mm, Ms, Mm, Mm, Aa, Aa, Re, Re, Re, Re, Re, Ms, Ha, Mm, Mm, Mm, Mm, Mm, Ha, Ha, Mm, Aa, Hhd, Mm, Mm
Mm, Mm, Mm, Ha, Ms, Hh, Ms, Hh, Mm, Mm, Aa, Aa, Ms, Ms, Ms, Hhd, Mm, Mm, Mm, Mm, Hhd, Hhd, Ha, Ms, Hhd, Ms, Ms, Ha, Ms, Hhd, Mm, Mm, Aa, Ms, Mm, Mm, Mm, Mm, Mm, Mm, Mm, Aa, Aa, Aa, Mm, Mm
Mm, Mm, Mm, Ms, Mm, Ms, Mm, Mm, Mm, Mm, Mm, Mm, Ai, Ms, Hhd, Mm, Mm, Mm, Mm, Mm, Mm, Ha, Hhd, Mm, Hhd, Ms, Mm, Mm, Ms, Mm, Hhd, Hhd, Aa, Ms, Ms, Mm, Mm, Mm, Ms, Mm, Mm, Mm, Mm, Hhd, Mm, Mm
Mm, Mm, Mm, Mm, Mm, Mm, Mm, Mm, Hhd, Hhd, Ww, Ww, Mm, Mm, Mm, Aa, Aa, Mm, Mm, Mm, Hhd, Hhd, Ms, Ms, Mm, Ms, Ms, Ms, Ha, Ha, Hhd, Hhd, Ha, Mm, Mm, Mm, Mm, Mm, Ha, Mm, Re^Vct, Mm, Ms, Mm, Mm, Mm
Ww, Mm, Mm, Mm, Aa, Aa, Mm, Mm, Hhd, Ha, Ai, Ha, Aa, Mm, Mm, Aa, Mm, Mm, Mm, Mm, Mm, Mm, Mm, Ms, Mm, Mm, Mm, Mm, Ms, Ha, Ha, Ha, Mm, Mm, Mm, Mm, Mm, Mm, Re^Vct, Ha, Cea, Mm, Ms, Ms, Mm, Mm
Mm, Ww, Ai, Ha, Mm, Hhd, Hhd, Mm, Mm, Ha, Ww, Hh, Mm, Mm, Mm, Ms, Mm, Mm, Mm, Mm, Mm, Aa, Aa, Mm, Mm, Mm, Mm, Ms, Mm, Ha, Mm, Mm, Mm, Mm, Aa, Aa, Aa, Hhd, Hhd, Cea, Kea, Ms, Mm, Mm, Mm, Mm
Mm, Ms, Ms, Ww, Mm, Mm, Hhd, Mm, Mm, Mm, Ww, Ms, Mm, Mm, Mm, Mm, Mm, Mm, Ha, Mm, Hhd, Aa, Hhd, Mm, Mm, Mm, Mm, Mm, Mm, Mm, Mm, Mm, Ms, Mm, Mm, Ha, Ha, Hhd, Re^Vct, Cea, Ms, Ms, Aa, Mm, Mm, Mm
Mm, Mm, Mm, Ww, Ms, Mm, Ms, Ms, Ai, Ww, Ms, Ms, Mm, Mm, Mm, Mm, Mm, Ha, Ha, Ms, Ms, Aa, Hhd, Ha, Ha, Mm, Ms, Hhd, Mm, Mm, Ms, Ms, Mm, Mm, Mm, Ha, Ha, Hhd, Mm, Mm, Ha, Aa, Hhd, Hhd, Mm, Mm
Mm, Mm, Mm, Ai, Ww, Ms, Ms, Ai, Ms, Mm, Mm, Ms, Mm, Hhd, Hhd, Mm, Hhd, Ha, Hh, Ms, Mm, Hhd, Hhd, Hhd, Ha, Ms, Ms, Hhd, Mm, Mm, Hhd, Mm, Hh, Hh, Hh, Mm, Mm, Mm, Mm, Mm, Ha, Mm, Mm, Mm, Mm, Mm
Mm, Hhd, Hh, Ha, Ha, Ww, Ww, Ww, Hhd, Mm, Mm, Mm, Mm, Hhd, Mm, Mm, Mm, Hh, Hhd, Mm, Mm, Mm, Mm, Ha, Ms, Ms, Ms, Mm, Hhd, Hhd, Mm, Mm, Ha, Ha, Hh, Mm, Mm, Mm, Mm, Mm, Ms, Mm, Mm, Mm, Mm, Mm
Mm, Mm, Hhd, Hh, Mm, Ms, Aa, Ww, Hhd, Ms, Mm, Mm, Mm, Mm, Mm, Mm, Mm, Mm, Hhd, Mm, Mm, Mm, Mm, Mm, Mm, Ms, Ms, Ms, Mm, Mm, Aa, Aa, Ha, Ha, Mm, Mm, Mm, Mm, Ms, Ms, Ha, Mm, Hhd, Ms, Ms, Mm
Mm, Mm, Mm, Mm, Mm, Mm, Mm, Ai, Ai, Ha, Ha, Ms, Ms, Mm, Mm, Mm, Ms, Hhd, Ha, Mm, Ha, Mm, Mm, Mm, Mm, Ms, Ms, Mm, Mm, Mm, Mm, Hhd, Hh, Mm, Mm, Mm, Mm, Ms, Ms, Ha, Ha, Hhd, Hhd, Ha, Ms, Mm
Mm, Mm, Mm, Mm, Mm, Mm, Ms, Ms, Mm, Ww, Ww, Aa, Ms, Ms, Mm, Ms, Ai, Ww, Ww, Ha, Ha, Mm, Mm, Mm, Mm, Ms, Mm, Mm, Mm, Mm, Ha, Hhd, Ms, Mm, Mm, Mm, Ms, Mm, Mm, Ms, Mm, Hhd, Aa, Ha, Mm, Mm
Gd, Mm, Hhd, Mm, Mm, Mm, Mm, Ms, Ms, Mm, Ww, Ww, Ai, Ww, Ww, Ww, Ha, Ha, Mm, Ai, Ai, Ms, Mm, Aa, Mm, Mm, Ms, Ha, Ha, Mm, Ha, Ms, Mm, Mm, Ms, Ms, Ms, Ms, Mm, Mm, Ms, Ms, Aa, Mm, Mm, Mm
Hhd, Gd, Gd, Gd, Hhd, Mm, Mm, Mm, Ha, Ai, Mm, Mm, Ms, Mm, Aa, Aa, Uh, Uh, Xu, Mm, Ms, Ww, Ww, Aa, Mm, Mm, Ms, Ha, Ms, Hh, Mm, Mm, Mm, Mm, Hh, Aa, Ms, Hh, Hhd, Hhd, Mm, Ms, Ms, Mm, Mm, Mm
Hh, Hhd, Hh, Gs, Hhd, Hhd, Mm, Mm, Ww, Ai, Ms, Ha, Ha, Ms, Xu, Xu, Uu, Uu, Uu, Xu, Xu, Xu, Ms, Ai, Mm, Ha, Mm, Ms, Mm, Mm, Mm, Aa, Aa, Hh, Ha, Ha, Hhd, Hh, Mm, Mm, Hhd, Mm, Ms, Mm, Mm, Mm
Hh, Hh, Gs, Gs, Gd, Gs, Gd, Hhd, Ww, Hhd, Mm, Ms, Ms, Ms, Xu, Uu^Uf, Uu, Qxu, Qxu, Uu, Xu, Mm, Mm, Ww, Ww, Mm, Mm, Mm, Mm, Mm, Mm, Mm, Mm, Hh, Hh, Ha, Mm, Mm, Mm, Hhd, Mm, Mm, Mm, Mm, Mm, Mm
Gs, Gs, Gs, Gs, Gs, Gs, Gd, Ww, Hhd, Hhd, Mm, Mm, Mm, Mm, Xu, Uu, Uu, Qxu, Uu, Uu^Uf, Xu, Mm, Mm, Mm, Ww, Mm, Mm, Mm, Mm, Mm, Mm, Mm, Mm, Mm, Mm, Mm, Mm, Mm, Mm, Mm, Mm, Mm, Mm, Mm, Mm, Mm
