Wog, Wog, Wog, Wog, Wog, Wog, Wo, Wo, Wo, Wo, Wo, Wo, Wo, Wo, Wwt, Wwt, Dd, Dd, Gs, Gs, Gg, Gg, Gg, Gs, Gs, Gg, Gg, Gg, Gg, Gg, Gg, Gg, Gg, Gg, Gs, Gg, Gs, Gg, Gg, Gg, Gs, Gg, Gg
Wog, Wog, Wog, Wog, Wog, Wog, Wo, Wo, Wo, Wo, Wo, Wo, Wo, Ww, Ww^Ewl, Ww^Ewl, Ds, Ds, Gs, Gg, Gd, Gg, Gg, Gs, Gs, Gg, Gs, Gs, Gs, Gs, Gs, Gs, Gd^Es, Gd, Gg, Gs, Gs, Gs, Gg, Gs, Gs, Gg, Gg
Wog, Wog, Wog, Wog, Wog, Wog, Wo, Wo, Wo, Wo, Wo, Wo, Ww, Ww, Ww, Ww^Ewf, Ds, Ds, Gs, Gd, Dd, Mm, Gg, Gg, Gs, Gs, Gg, Gg, Gg, Gs, Hh^Fms, Gg, Gd, Gg, Hh, Gg, Gg, Gs^Efm, Hh^Fms, Hh, Gs, Gs, Gg
Wog, Wog, Wog, Wog, Wo, Wo, Wo, Wo, Wo, Wo, Wo, Ww, Ww, Ww, Ds, Ds, Gs, Gs, Gs, Gd, Dd, Hh^Fms, Hh, Gs, Gs, Hh, Gs, Gg, Hh, Mm, Hh^Fms, Gg, Gs, Gg, Gs, Gg, Gs^Fms, Hh, Mm, Mm, Gg, Gs, Gg
Wog, Wog, Wog, Wog, Wo, Wo, Wo, Wo, Wo, Wo, Ww, Wwr, Wwr, Ds, Ds, Ds, Gd, Gs, Gs, Gs, Gs, Gs^Fms, Gs, Gs, Gs, Gg, Gs^Es, Gs, Rb, Sm, Gs^Em, Gg, Gs, Gs, Gs, Gg, Gg, Hh, Hh, Hh, Gg, Gg, Gg
Wog, Wog, Wog, Wo, Wo, Wo, Wo, Wo, Wo, Wo, Ww, Ww, Ww, Ds, Gd, Gd, Dd, Gd, Gg, Gs, Gs, Gs, Gs, Gs, Gs, Gs, Gd, Gd, Gg^Efm, Gs, Gg, Gg, Gg, Gs, Hh, Gs, Gd, Gg, Gs, Gs, Gs, Gg, Gg
Wog, Wog, Wog, Wo, Wo, Wo, Wo, Wo, Wwr, Ww, Ww, Ww, Ds, Ds, Gd, Dd, Hh, Gd, Gg, Gs, Gs, Gs, Ce, Ce, Ce, Gs, Gs, Gg, Gs^Fms, Gs^Fms, Gg, Gd, Gd, Gs^Fms, Hh, Gg, Gs^Es, Gd, Gd, Gs, Gs, Gs, Gg
Wog, Wog, Wo, Wo, Wo, Wo, Wo, Ww, Wwr, Wwr, Ds, Ds, Gs, Gs, Gd, Hh, Hh^Fms, Mm, Gg, Gg, Gs, Gs^Es, Ce, Ke, Ce, Gs, Gs, Gg, Gg, Gs^Fms, Gs, Gd, Gg, Hh, Mm, Gg, Gs, Gs, Gs, Gg, Gg, Gg, Gg
Wog, Wog, Wo, Wo, Wo, Wo, Wo, Ww, Ww, Ds, Ds, Ds, Gs, Gs, Gs, Gs, Gg, Gs^Fms, Gs, Gs, Gg, Gs, Gs^Es, Ce, Gs, Gs, Gg, Gg, Gg^Es, Gg, Gs, Gg, Gg, Hh, Gg, Gs, Gg, Gs, Mm, Hh, Hh, Gg, Gg
Wog, Wog, Wo, Wo, Wo, Wo, Ww, Ww, Ww, Wwr, Ds, Gs, Gg, Gs, Gs, Gg, Gg, Gg, Gs, Re^Vct, Gg, Gg, Gg, Gs, Gg, Gs^Vct, Gg, Gg, Gg, Gg, Gg, Gg^Em, Gs, Gg, Gd, Gs, Gs, Gg, Gg, Hh, Gg, Gg, Gg
Wog, Wog, Wog, Wo, Wo, Wo, Ww, Ww, Ds, Wwr, Ds, Gs, Gg, Gs^Fms, Gs^Fms, Gg, Gg, Gs, Gs, Gs, Gs, Hh, Rb^Fms, Gg, Gs, Gs, Gg, Hh^Uf, Hh, Gs, Gs, Gg, Gg, Gd, Sm, Rb^Em, Gs, Gg, Gs, Gg, Gs^Fms, Gg, Gg
Wog, Wog, Wog, Wo, Wo, Wo, Ww, Ww, Ds, Ds, Gs, Gs, Dd, Hh^Fms, Hh, Gs, Gg, Gg, Gg, Gs, Gs, Mm, Sm, Gd^Uf, Gs, Gg, Gg, Mm, Gg, Gg, Gs, Gg^Es, Gg, Gs^Fms, Hh^Fms, Hh, Gs, Gs, Gs, Gs^Fms, Gs^Fms, Gg^Efm, Gg
Wog, Wog, Wo, Wo, Wo, Wo, Ww, Ww, Ds, Ds, Gs, Gg, Dd, Mm, Hh, Gs, Gg, Hh, Mm, Gg, Gs, Gs, Gs, Gd^Em, Gs, Gs, Gs, Gg, Gs, Gs, Gs, Gg, Gg, Mm, Gg, Gs, Gs, Gs, Gs, Gg, Gg, Gg, Gd
Wog, Wog, Wo, Wo, Wo, Wo, Ww, Ww, Ds, Gs, Gg, Gg, Gg, Gg, Gg, Gs, Gs, Gg, Gg, Gg, Gg, Gg, Gg, Gg, Gg, Gs, Rb, Gs, Gs, Gs^Fms, Gg, Gg, Gs, Gg, Gs, Gs^Edt, Ce, Ce, Ce, Gs, Gs, Gd, Gg
Wog, Wog, Wo, Wo, Wo, Ww, Ww, Ds, Ds, Gs, Gs, Gg, Gs, Gs, Gs, Gg, Gg, Gs, Gg, Gg, Gd^Fms, Gg, Gs, Gs, Mm, Hh, Sm, Gs, Gg, Gs, Gg, Gs, Gs, Gs^Vct, Gs, Gs, Ce, Ke, Ce, Gs, Gs^Es, Gs, Gg
Wo, Wo, Wo, Wo, Ww, Ww, Ww^Ewf, Ds, Ds, Ds, Gs, Gg, Gg, Gs, Gg, Gs, Gg, Gg, Gg, Gg, Gg, Gg, Gs, Gs, Gs, Mm, Gs^Fms, Gs, Gg, Gg, Hh^Uf, Gg, Gg, Gg, Gs, Gs, Gs, Ce, Gs^Edt, Gs, Gs, Gg, Gg
Wo, Wo, Wo, Wo, Ww, Ww^Ewf, Ww, Ds, Gs, Gs, Gg, Gs, Gs^Es, Gs, Gs, Gs, Gg, Gg, Gs, Gg, Gg, Gg, Gs, Gs, Gs, Gs^Fms, Gg, Gg, Gg, Gd^Em, Hh^Fms, Hh, Gs, Gg^Es, Gg, Gs, Gs, Gs, Gs, Gs, Gg, Hh, Gg
Wo, Wo, Wo, Wo, Ww, Ww, Ds, Ds, Gs, Gg, Gg^Fms, Gg, Gg, Gs, Gs, Gs, Gs, Gs, Gs, Hh, Mm, Gg, Gg, Gs, Gs, Gg, Gs, Gs, Gs, Gg, Gg, Gg, Gs, Gg, Gg, Gs^Vct, Gs, Gs^Es, Gs, Gg, Gs, Gg, Gd
Wo, Wo, Wo, Wwr, Wwr, Ds, Gs, Gs, Gd, Hh, Hh, Gg, Gs, Gs, Ce, Ce, Ce, Gs, Gs, Hh, Sm, Rb, Gg, Gs, Gs, Gs, Gg, Gs, Gg, Gg, Gg, Gg, Gs, Gs^Fms, Gg, Gs, Gg, Gs, Hh, Gs, Gs, Gs, Gg
Wo, Wo, Wo, Ww, Wwr, Ds, Gs, Gs, Dd, Dd, Gs, Gg, Gs, Gs, Ce, Ke, Ce, Gs, Gs, Gg^Em, Gd, Gd, Gs, Gs, Gg, Gg, Gs^Fms, Gs^Fms, Hh^Fms, Gs, Gg^Efm, Gg, Gg, Gs, Gd, Gg, Hh, Hh, Gs, Gs, Gs, Gg, Gg
Wo, Wo, Wo, Ww, Ww, Ds, Gs, Gs, Gs, Gs, Gs, Gs, Gs, Gs, Gs, Ce, Gs, Gs, Gs, Gg, Gg, Gs, Gg, Gs, Gs, Gd, Sm, Mm, Hh, Gs, Gs, Gs, Gs, Gd, Gd, Gg, Gs, Mm, Gg, Gs, Gd, Gd, Gd
Wo, Wo, Wo, Ww, Ww, Ds, Gs, Gg^Es, Gs, Gs, Gs, Gg, Gg, Gs, Gs, Gs, Gs, Gs, Gs, Gg, Gg, Gg, Gs, Gg, Gg, Rb, Rb, Hh, Gg, Gs, Gd, Rb, Hh, Gg, Gg, Gs, Gg, Gg, Gs, Gs, Gg, Gd, Gd
Wo, Wo, Wo, Ww, Ww^Ewf, Ds, Gs, Gg, Gs, Gg, Hh, Gg, Gg, Gg, Gg, Gs, Gg, Gs, Gg, Gg, Hh, Mm, Gs, Gs, Gg, Gs, Gd, Gd, Gg, Gs, Gd, Sm, Hh^Fms, Gs^Fms, Gs, Gs, Gs, Gg, Gg, Gs^Fms, Hh, Gg, Gg
Wo, Wo, Ww, Ww, Ds, Ds, Gs, Gg, Gg, Gg^Efm, Hh^Fms, Mm, Gg, Gg, Gg, Gs, Gs, Gs, Gg, Rb^Fms, Sm, Hh, Gs, Gs, Gs, Gd, Gg, Hh, Gs, Gs, Gs, Mm, Gs, Gg, Gg, Gs, Gs, Gg^Efm, Gg, Gg, Gs, Gs, Gg
Wo, Wo, Ww, Ww, Ds, Ds, Ds, Gs, Gd, Gs^Fms, Hh, Mm, Gg, Gg, Gs, Gg, Gg, Gs, Gg, Gg, Gg, Rb, Gg, Gg, Gd, Gg, Gg, Gg, Gs, Gs, Gg, Gg, Gs, Gg, Gs, Gs, Rb, Gs, Hh, Gs, Gs, Gs, Gg
Wo, Wo, Ww, Ww, Wwr, Ds, Ds, Gs, Dd, Gd, Gg, Gg, Gg, Gd^Vc, Rb, Sm, Hh^Fms, Gg, Gs, Gs, Gg, Gg, Gll^Gvs, Gll^Gvs, Gll^Gvs, Gs, Gs, Gs, Gg, Gs, Gg, Gg, Gs, Gs, Gd, Rb, Sm, Hh, Mm, Gs, Gs, Gs, Gg
Wo, Wo, Wo, Ww, Ww, Wwr, Ds, Gs, Gs, Dd, Gg, Gg, Gll^Uf, Gg^Em, Gs, Mm, Hh, Gg^Efm, Gs, Gg, Gs, Gll^Gvs, Gll^Gvs, Gll^Gvs, Gll^Gvs, Gg, Gs, Gs, Hh^Uf, Hh^Fms, Gg, Gs, Gs, Gs^Es, Gs, Gd, Gd, Mm, Gs, Gs, Gd, Gs, Gg
Wog, Wo, Wo, Wo, Ww, Ww, Ds, Ds, Gd, Gs, Gs, Gs, Gs, Gg, Gs, Gs, Gs, Gs, Gg, Gg^Efm, Gd^Vh, Gll^Gvs, Gll^Gvs, Gll^Gvs, Gg, Gs, Gs, Gg, Gg^Em, Hh, Gg, Gs, Rb, Gs, Gs, Gs, Gs, Gg, Gg, Gd, Gg, Gs, Gs
Wog, Wog, Wo, Wo, Ww, Ww, Ww, Ds^Bw/, Ds, Gd, Gd, Gs, Gs, Gs, Ket, Gs, Gs, Gs, Gs^Fms, Gs^Fms, Gg, Gll^Gvs, Gg, Gg, Gs, Gg, Gg, Gs, Gs, Gg, Gg, Gd, Sm, Gs^Fms, Gs^Fms, Gg, Gg, Gg, Gg^Es, Gs, Hh, Gs, Gs
Wog, Wog, Wo, Wo, Wo, Ww, Ww^Ewf, Ds, Ds, Gd^Vc, Dd, Gd, Gs, Ket, Ket, Ket, Gg, Gs, Gg, Gs^Fms, Gs, Gs, Gs, Gg, Gll^Gvs, Gll^Gvs, Gll^Gvs, Gg, Gs, Gs, Gg, Gs, Hh, Mm, Mm, Gg, Gs, Gg^Efm, Gg, Gg, Gd, Gs, Gs
Wog, Wog, Wo, Wo, Wo, Ww, Ww^Ewl, Ds, Ds, Dd, Gd, Gd, Gs, Ket, Ket, Ket, Gg, Gg^Efm, Gs, Gs, Gs, Gd^Wm, Gg, Gll^Gvs, Gll^Gvs, Gll^Gvs, Gll^Gvs, Gll^Gvs, Gll^Gvs, Gs, Gs, Gs, Gg, Mm, Gg, Gs, Gg, Gg, Hh^Fms, Gd, Gd, Gg, Gs
Wog, Wog, Wo, Wo, Wo, Wo, Ww, Ww, Ww, Ds^Bw/, Ds, Gs, Gs, Gs, Gs, Gs, Gs, Gg, Gs^Vh, Gll^Gvs, Gll^Gvs, Gs, Gs, Gs^Vh, Gs, Gll^Gvs, Gll^Gvs, Gll^Gvs, Gs, Gg, Gs, Gg, Gs, Gs, Gs, Gs, Gg, Gs^Fms, Hh^Fms, Mm, Gg, Gs, Gs
Wog, Wog, Wog, Wo, Wo, Wo, Wo, Ww, Ww, Wwr, Ds, Ds, Gs, Gs, Gd, Dd, Hh^Fms, Gs, Gs, Gll^Gvs, Gll^Gvs, Gll^Gvs, Gll^Gvs, Gs, Gs, Gs, Gg, Gg, Gg, Gs^Efm, Gs^Fms, Gs, Gg, Gs, Gs, Gs, Gg, Hh, Hh, Gs^Fms, Gg, Gs, Gs
Wog, Wog, Wog, Wo, Wo, Wo, Wo, Wo, Ww, Ww, Ds, Ds, Ds, Gs, Gd, Dd, Gg, Gs, Gg, Gll^Gvs, Gll^Gvs, Gll^Gvs, Gll^Gvs, Gg, Gg, Gs, Gg, Gd, Gs, Hh, Hh^Fms, Gg, Gg, Gs, Gs^Em, Gs^Em, Gg, Gg, Gg, Gg, Gs, Gs, Gg
Wog, Wog, Wog, Wo, Wo, Wo, Wo, Wo, Wo, Ww, Wwr, Ds, Ds, Ds, Ds, Gd, Gs, Gg, Gd, Gg, Gg, Gll^Gvs, Gll^Gvs, Gs, Gg, Gs, Gg, Gg, Gs, Hh, Gg, Gg, Gg, Gg, Gd, Gd^Es, Gs, Gs, Gs, Gg, Gs, Gs, Gg
Wog, Wog, Wog, Wog, Wo, Wo, Wo, Wo, Wo, Wo, Ww, Ww, Ds, Ds, Ds, Ds, Gg, Gd, Gd, Gd, Gg, Gg, Gg, Gg, Gg, Gg, Gg, Gs, Gg, Gg, Gg, Gg, Gg, Gg, Gg, Gg, Gg, Gs, Gs, Gs, Gg, Gs, Gg
