Qlf, Qlf, Qlf, Qlf, Qlf, Qxu, Qlf, Qlf, Qlf, Qlf, Qlf, Qlf, Qlf, Qlf, Qlf, Qxu, Qlf, Qlf, Qlf, Qlf, Qlf, Qxu, Rb, Rb, Rb^Es, Rb, Rb, Rb^Fdw, Rb^Fdw, Rb, Rb^Es, Rb, Ds^Es, Ds, Hd^Edb, Ds^Edb, Rb, Rb^Edb, Rb^Edb, Ds^Edb, Ds^Edb, Ds^Edb
Qlf, Qlf, Qlf, Qlf, Qxu, Qxu, Qxu, Qlf, Qlf, Qlf, Qlf, Qlf, Qlf, Qlf, Qxu, Qxu, Qlf, Qlf, Qlf, Qlf, Qxu, Qxu, Hhd, Rb^Es, Ds^Es, Hhd^Es, Ds, Rb^Fdw, Rb^Fdw, Rb, Rb^Es, Hhd^Es, Ds^Es, Ds, Hhd, Hhd^Edb, Rb^Edb, Rb^Edb, Cud, Rb^Edb, Hhd^Edb, Hd^Edb
Qlf, Qlf, Qlf, Qlf, Qxu, Qlf, Qlf, Qxu, Qxu, Qlf, Qlf, Qlf, Qlf, Qxu, Qxu, Qlf, Qxu, Qlf, Qxu, Qxu, Ds, Hd, Hhd^Fdw, Rb^Fdw, Rb^Edb, Hd, Ds, Rb, Ds, Ds, Rb^Vhcr, Rb^Edb, Rb^Edb, Ds, Rb, Hhd^Fdw, Rb^Edb, Cud, Kud, Cud, Hhd^Edb, Hhd^Edb
Qlf, Qlf, Qxu, Qxu, Qlf, Qlf, Qlf, Qlf, Qlf, Qxu, Qxu, Qlf, Qxu, Qxu, Qlf, Qxu, Hhd, Qxu, Rb^Fdw, Rb, Rb^Edb, Rb, Rb, Rb^Fdw, Rb^Edb, Rb^Edb, Rb, Rb^Es, Rb^Edb, Rb, Rb, Rb^Edb, Rb^Edb, Rb, Rb^Edb, Rb^Edb, Rb^Edb, Cud, Cud, Cud, Rb^Edb, Rb^Edb
Qxu, Qxu, Qxu, Qlf, Qlf, Qlf, Qlf, Qlf, Qlf, Qlf, Qxu, Qxu, Qlf, Qlf, Qlf, Qxu, Hhd^Es, Rb^Es, Ds^Edb, Hd^Edb, Rb^Edb, Rb, Qxu, Rb, Qxu, Rb^Edb, Qxu^Bw|r, Rb, Hhd^Fdw, Hhd^Fdw, Hd^Es, Ds^Edb, Rb, Rb, Ds, Rb^Edb, Rb^Edb, Rb^Edb, Rb^Edb, Rb^Edb, Rb^Edb, Ds^Edb
Qlf, Qlf, Qxu, Qlf, Qlf, Qlf, Qlf, Qlf, Qlf, Qlf, Qlf, Qxu, Qlf, Qlf, Qxu, Qxu, Rb^Es, Rb, Ds^Edb, Ds^Edb, Qxu, Qxu^Bw|r, Ww, Qxu, Ww, Qxu, Ww, Qxu, Qxu, Hhd, Rb^Es, Ds, Rb, Rb, Ds^Vhcr, Ds^Es, Hhd^Edb, Rb^Edb, Rb^Fdw, Hhd^Fdw, Rb^Edb, Rb^Edb
Qlf, Qlf, Qlf, Qxu, Qxu, Qxu, Qxu, Qlf, Qlf, Qlf, Qlf, Qxu, Qxu, Qxu, Ds, Rb^Fdw, Hhd^Fdw, Rb, Qxu, Qxu, Ww, Ww, Coa, Ww, Coa, Ww, Coa, Ww, Ww, Qxu, Qxu^Bw/r, Rb, Rb^Es, Rb^Es, Rb, Hd, Hhd, Rb, Rb, Hhd, Ds, Rb^Edb
Qlf, Qlf, Qlf, Qxu, Ds, Ds, Rb, Qxu, Qxu, Qlf, Qxu, Qxu, Qxu, Ds, Ds^Edb, Hd^Edb, Hhd, Qxu, Ww, Ww, Coa, Coa, Ha, Coa, Re^Es, Coa, Aa, Coa, Coa, Ww, Ww, Qxu, Hd^Es, Rb, Rb^Edb, Rb^Edb, Rb^Edb, Rb, Rb^Vhcr, Ds^Es, Ds, Rb
Qxu, Qlf, Qxu, Qxu, Rb, Hd, Qxu, Hhd, Hhd, Qxu, Qxu, Qlf, Qlf, Qxu, Rb^Edb, Rb^Edb, Qxu, Qxu^Bw\r, Ww, Coa, Aa, Re, Hhd, Hhd, Re^Es, Aa^Voa, Re, Ha, Hhd, Coa, Ww, Qxu, Qxu, Hd^Es, Rb^Es, Hhd^Edb, Rb^Edb, Rb, Rb^Es, Rb^Es, Rb^Fdw, Rb
Qlf, Qxu, Rb, Rb, Rb, Qxu, Rb, Ds, Ds, Hd, Qxu, Qlf, Qxu, Qxu, Hd, Rb^Edb, Qxu, Ww, Coa, Coa, Aa, Re, Hhd^Vo, Hhd, Re, Re, Re, Hhd, Hhd, Coa, Coa, Ww, Qxu, Rb, Rb^Es, Rb, Ds, Rb, Rb, Hhd, Hhd, Rb
Qlf, Qxu, Ds^Es, Rb^Es, Qxu, Qxu, Rb^Es, Ds, Qxu, Qxu, Qlf, Qlf, Qxu, Hhd, Rb^Fdw, Qxu, Ww, Ww, Coa, Ha, Hhd, Re, Re, Aa, Kte, Cte, Aa, Aa^Voa, Re, Ha, Coa, Ww, Ww, Qxu^Bw/r, Rb^Fdw, Rb^Fdw, Ds^Es, Rb^Edb, Rb^Edb, Hhd^Edb, Hd^Es, Ds^Es
Qlf, Qxu, Hd, Ds, Qxu, Rb^Edb, Rb^Edb, Qxu, Qlf, Qxu, Qxu, Qlf, Qxu, Qxu, Rb^Es, Qxu, Ww, Coa, Hhd, Hhd, Ha, Hhd, Aa, Re, Ha, Cte, Re, Re, Re, Aa, Aa, Coa, Ww, Qxu, Ds, Rb^Fdw, Hhd, Hd^Edb, Rb^Edb, Rb^Edb, Qxu, Ds^Es
Qxu, Qxu, Rb^Edb, Hhd^Edb, Qxu, Hhd^Edb, Hd^Edb, Qxu, Qlf, Qlf, Qlf, Qxu, Rb, Ds^Es, Ds, Qxu^Bw/r, Ww, Coa, Coa, Aa, Re^Voa, Re, Re^Es, Coa, Koa, Ha, Re, Aa, Ha, Re^Es, Coa, Coa, Ww, Qxu, Rb^Es, Rb, Rb, Rb^Edb, Ds, Rb, Qxu, Qxu
Qxu, Rb, Qxu, Rb^Edb, Qxu, Ds, Ds, Qxu, Qlf, Qlf, Qlf, Qxu, Qxu, Ds, Ds^Edb, Qxu, Qxu, Ww, Coa, Re, Re^Es, Re, Re, Coa, Aa, Coa, Re^Es, Hhd, Hhd, Hhd, Coa, Ww, Qxu, Qxu, Rb, Rb, Rb, Ds, Qxu, Qxu, Qlf, Qlf
Qxu, Rb, Ds, Rb^Es, Qxu, Ds, Rb^Es, Qxu, Qxu, Qlf, Qlf, Qlf, Qxu, Hhd^Edb, Hd^Edb, Rb^Edb, Qxu, Ww, Ww, Coa, Hhd, Hhd, Aa^Voa, Re^Es, Hhd, Re^Es, Re, Hhd^Voa, Hhd, Coa, Ww, Ww, Qxu^Bw\r, Rb, Ds^Edb, Hd^Edb, Hhd^Edb, Rb, Qxu, Qlf, Qlf, Qlf
Qlf, Qxu, Rb, Ds, Qxu, Rb, Rb^Edb, Rb, Hhd^Edb, Qxu, Qlf, Qlf, Qxu, Hhd^Edb, Rb^Fdw, Rb^Fdw, Qxu, Qxu, Ww, Coa, Coa, Aa, Aa, Hhd, Hhd, Ha, Aa, Aa, Coa, Coa, Ww, Qxu, Rb^Es, Rb, Hd^Edb, Ds^Edb, Hhd^Edb, Rb^Fdw, Qxu, Qlf, Qlf, Qlf
Qlf, Qxu, Hhd, Hhd, Rb^Edb, Qxu, Qxu, Hhd^Edb, Hd, Qxu, Qxu, Qlf, Qlf, Qxu, Qxu, Qxu, Rb^Edb, Qxu, Qxu^Bw/r, Ww, Ww, Coa, Coa, Coa, Coa, Coa, Coa, Coa, Ww, Ww, Qxu, Qxu, Rb^Es, Rb^Es, Hhd, Hd, Qxu, Rb^Fdw, Qxu, Qlf, Qlf, Qlf
Qlf, Qxu, Qxu, Hhd^Edb, Rb^Edb, Rb^Edb, Ds, Qxu, Ds, Ds, Rb^Es, Qxu, Qxu, Qxu, Hd^Es, Hhd, Rb^Edb, Rb^Edb, Qxu, Qxu, Qxu, Ww, Ww, Ww, Ww, Ww, Ww, Ww, Qxu^Bw|r, Qxu, Ds^Edb, Rb, Hhd^Fdw, Rb^Fdw, Qxu, Qxu, Qlf, Qxu, Rb, Qxu, Qxu, Qlf
Qxu, Qxu, Qxu, Rb^Edb, Rb^Edb, Rb, Ds^Es, Qxu, Qxu, Ds, Rb^Edb, Rb^Es, Rb, Ds, Ds, Rb^Es, Rb^Edb, Rb^Edb, Qxu, Qxu, Qlf, Qxu, Qxu, Qxu^Bw|r, Qxu, Qxu, Qxu, Qxu, Rb, Ds^Edb, Ds^Edb, Rb, Rb, Hhd^Fdw, Qxu, Qlf, Qxu, Qxu, Rb^Es, Rb, Rb^Edb, Qxu
Qlf, Qlf, Qlf, Qxu, Qxu, Qxu, Qxu, Hd^Es, Hhd, Qxu, Qxu, Rb^Edb, Qxu, Ds, Qxu, Qxu, Qxu, Qxu, Qxu, Qlf, Qlf, Qxu, Hhd, Rb, Ds^Edb, Rb^Edb, Rb^Edb, Rb, Rb, Hd^Edb, Hhd, Qxu, Qxu, Qxu, Qlf, Qlf, Qxu, Rb, Rb, Qxu, Rb^Edb, Qxu
Qlf, Qlf, Qlf, Qxu, Hhd, Hhd, Qxu, Hhd, Rb, Rb^Edb, Rb^Es, Qxu, Qxu, Qxu, Ds, Rb, Rb^Edb, Rb, Rb, Qxu, Qxu, Qxu, Hhd^Es, Ds^Es, Ds, Rb^Edb, Qxu, Rb^Fdw, Qxu, Qxu, Qxu, Hhd, Qxu, Qlf, Qxu, Qlf, Qxu, Rb, Hhd, Hd^Edb, Ds^Edb, Qxu
Qlf, Qlf, Qxu, Qxu, Rb, Hd, Rb, Qxu, Qxu, Rb^Edb, Rb^Es, Hhd^Es, Hd, Ds, Ds, Rb^Edb, Rb^Edb, Qxu, Rb, Hhd, Hd, Qxu, Qxu, Rb^Es, Qxu, Qxu, Qlf, Qxu, Qlf, Qlf, Qxu, Qxu, Qxu, Qxu, Rb, Qxu, Ds, Hhd^Es, Qxu, Ds, Ds, Qxu
Qlf, Qxu, Hhd, Rb, Rb, Ds, Hd, Hhd, Hd, Qxu, Qxu, Hhd, Qxu, Ds, Ds, Rb, Rb, Hhd, Rb, Ds, Ds, Ds, Hd^Es, Qxu, Qxu, Qlf, Qxu, Qlf, Qxu, Qxu, Hhd, Rb, Rb^Edb, Rb, Rb^Edb, Ds, Ds^Es, Hd, Qxu, Hd, Rb, Qxu
Qlf, Qxu, Re, Rb, Qxu, Ds, Qxu, Hhd, Ds, Ds, Rb, Qxu, Qxu, Ds, Qxu, Qxu, Qxu, Qxu, Qxu, Ds, Qxu, Ds, Hhd^Es, Qxu, Rb, Qxu, Rb, Qxu, Rb, Qxu, Hd, Hhd, Rb^Es, Rb, Qxu, Rb, Rb, Qxu, Rb, Rb, Rb, Qxu
Qxu, Qxu, Re, Re, Re, Qxu, Qxu, Qxu, Qxu, Qxu, Rb, Rb^Edb, Rb, Qxu, Ds, Rb, Rb, Hhd, Rb, Qxu, Ds, Qxu, Rb, Rb^Es, Rb, Ds, Hhd, Rb, Rb, Ds, Ds, Qxu, Qxu, Qxu, Rb, Qxu, Qxu, Qxu, Qxu, Hhd^Es, Rb, Qxu
Qxu, Qxu, Re, Re, Re, Hhd, Gll, Gll, Gll, Qxu, Hhd, Hhd^Edb, Rb, Hd, Ds, Rb, Rb, Qxu, Hhd, Ds, Ds^Edb, Qxu, Qxu, Rb^Edb, Rb^Edb, Ds, Hhd, Rb, Rb, Rb, Qxu, Qxu, Hhd, Rb, Rb^Es, Rb, Hhd, Hd, Ds, Rb^Edb, Qxu, Qxu
Qxu, Qxu, Qxu, Re, Qxu, Gll, Qxu, Gll, Gll, Qxu, Qxu, Rb, Qxu, Ds, Qxu, Rb, Qxu, Qxu, Qxu, Hd^Edb, Rb, Rb, Rb, Qxu, Qxu, Qxu, Qxu, Qxu, Qxu, Qxu, Rb, Hd, Qxu, Hhd^Edb, Rb, Rb, Qxu, Hd, Ds, Rb, Qxu, Qlf
Gd, Gd, Gd, Qxu, Gd, Qxu, Gd, Gll, Gs, Gll, Qxu, Qxu, Qxu, Qxu, Qlf, Qxu, Qlf, Qlf, Qxu, Hhd, Rb, Rb^Es, Rb, Hhd, Qxu, Ds, Hd, Hhd, Rb, Rb, Rb, Ds^Es, Rb, Rb^Edb, Qxu, Qxu, Qxu, Qxu, Qxu, Qxu, Qlf, Qlf
Gs^Fms, Gs^Em, Gs^Efm, Gd, Gs^Efm, Gd, Gs, Gs^Em, Gs, Gd, Qxu, Qxu, Qxu, Qlf, Qlf, Qlf, Qlf, Qlf, Qxu, Qxu, Qxu, Rb, Qxu, Hd, Ds, Ds, Ds^Edb, Rb^Edb, Rb, Hhd, Rb, Qxu, Qxu, Qxu, Qlf, Qlf, Qxu, Qlf, Qlf, Qlf, Qlf, Qlf
Gs^Fms, Gs^Fms, Gg^Efm, Gs^Fms, Gg^Es, Gg^Efm, Gs^Fms, Gs^Efm, Gg^Efm, Gd, Gd, Qxu, Qlf, Qlf, Qlf, Qlf, Qlf, Qxu, Qlf, Qlf, Qlf, Qxu, Qlf, Qxu, Qxu, Qxu, Qxu, Rb^Edb, Qxu, Qxu, Qxu, Qxu, Qlf, Qlf, Qlf, Qxu, Qxu, Qlf, Qlf, Qlf, Qlf, Qlf
Gs^Fms, Gg^Efm, Gg^Efm, Gg^Efm, Gs^Fms, Gs^Fms, Gs^Fms, Gs^Fms, Gg^Efm, Gs, Qxu, Qxu, Qlf, Qlf, Qlf, Qlf, Qlf, Qxu, Qlf, Qlf, Qlf, Qlf, Qlf, Qlf, Qlf, Qxu, Qxu, Qxu, Qlf, Qlf, Qlf, Qlf, Qlf, Qlf, Qlf, Qxu, Qxu, Qlf, Qlf, Qlf, Qlf, Qlf
