Gs, Gg, Gg, Gg, Gg, Gg, Gg, Gg, Hh, Gg, Ds, Ww, Ww, Ds, Gg, Gs^Fms, Gs^Fms, Gs^Fms, Gs^Fms, Gs^Fms, Hh^Fmf, Gs^Fms, Gg, Ds, Ww, Ds, Ds, Gs, Hh, Hh, Gs^Fms, Gs^Fms, Gs^Fms, Gs^Fms, Hh^Fms, Gs^Fms, Gs^Fms, Gs^Fms, Gs^Fms, Gs^Fms, Hh^Fms, Gll^Fmf, Gll^Fmf
Gs, Gg, Hh, Gg, Gg^Es, Gg, Gg, Hh, Hh, Hh, Gg, Ds, Ww, Ds, Ds, Gs^Fms, Gg^Em, Gll^Fmf, Gs^Efm, Hh^Fms, Hh^Fms, Gll^Fmf, Ds, Ds, Ww, Ww, Ds, Gs, Gs, Hh, Gs^Efm, Gs^Fms, Gs^Fms, Hh^Fms, Hh^Fmf, Gs^Fms, Gs^Fms, Gs^Fms, Gll^Fmf, Gll^Fmf, Hh^Fms, Hh^Fmf, Gs^Fms
Gg, Hh, Hh, Gg, Gg, Gg, Gg, Gs, Gg, Gg^Em, Gg, Ds, Ds, Wwr, Wwr, Ds, Gs^Es, Gs, Gs^Vhr, Gs, Gg, Gs^Fms, Ds, Ww, Ww, Ww, Ww, Ds, Ds, Gs, Hh^Fmf, Gs^Efm, Hh^Fms, Gs^Fms, Gll^Fmf, Gll^Fmf, Gs^Fms, Hh^Fmf, Hh^Fms, Gs^Fms, Gll^Fmf, Hh^Fms, Gs^Fms
Gg, Hh, Gg, Gs, Ce, Ce, Ce, Gs, Gg, Gg, Gs, Gg, Gg, Ds, Wwr, Ds, Ds, Gs, Gs, Gs, Ds, Ds, Wwr, Ww, Ds, Ds, Ds, Wwr, Ds, Gs, Gg, Hh, Hh^Fms, Gs^Fms, Hh^Fms, Hh^Fmf, Gs^Fms, Hh^Fmf, Hh^Fmf, Gs^Fms, Gll^Fmf, Gs^Fms, Gs^Fms
Gg, Gg, Gg, Gg, Ce, Ke, Ce, Gg, Gg, Gs, Gs, Gg^Es, Gg, Ds, Ds, Ww, Ww, Ds, Ds, Ds, Ww, Wwr, Ds, Ds, Gs^Fms, Gs^Fms, Ds, Wwr, Ds, Gg, Gg, Gg^Em, Gg, Gs^Fms, Gs^Fms, Gs^Fms, Gll^Fmf, Gs^Fms, Gs^Fms, Gs^Fms, Gs^Fms, Gll^Fmf, Gs^Fms
Hh, Gg, Gg, Gg, Gg, Ce, Gs, Gg, Gg, Gs, Ss, Gs, Gs, Gs, Gg, Ds, Ww, Ds, Wwr, Ds, Ww, Ds, Gg, Gg^Efm, Gs^Fms, Gs^Fms, Ds, Ww, Ww, Ds, Ds, Gg, Gg, Gg^Efm, Gg^Efm, Gs^Fms, Hh^Fms, Gs^Fms, Hh^Fms, Hh^Fms, Hh^Fmf, Gs^Fms, Gs^Fms
Hh, Hh, Gg, Gg, Gs, Gg, Hh, Gg^Es, Gd, Gd, Ss, Gs^Em, Gg, Gg, Gg, Ds, Ds, Ww, Wwr, Wwr, Ds, Ds, Gg, Gg, Gs, Gg, Gs, Ds, Ds, Ww, Ww, Ds, Gg, Gs^Fms, Gg, Hh^Fms, Hh, Gs^Fms, Gs^Fms, Hh^Fmf, Gs^Fms, Gs^Fms, Gs^Fms
Hh, Hh, Gg, Gs^Es, Gs, Gg, Hh, Hh, Gs, Ss, Gs, Gs, Gs^Fms, Gs^Fms, Gg, Gg, Ds, Ds, Wwr, Ds, Ds, Gg^Efm, Gs^Fmf, Gg, Gll^Vct, Gs^Es, Ss, Gs, Gs, Ds, Wwr, Ds, Gs, Gg, Gg, Hh, Gg, Gs^Fms, Gs^Fms, Gll^Fmf, Gs^Fms, Gll^Fmf, Gs^Fms
Gg, Gg, Gg, Gg, Gg, Gg, Gg, Gg, Gg, Gs, Gs, Gg, Gs^Fms, Gg, Gg, Ds, Wwr, Ww, Cvr^Efm, Ds, Gg, Gs^Fms, Gs^Fms, Gs^Edt, Gs, Gs^Es, Ss, Gs^Em, Gs, Ds, Wwr, Ds, Gs, Gs^Vct, Gg, Gg, Gg, Gg, Gg, Gg, Gg^Efm, Gs^Fms, Gs^Fms
Gs^Fms, Gg^Em, Ss, Gg, Gg, Gg, Gs, Gs, Ss, Gg, Gg, Gs^Fms, Gg, Gs, Gs, Ds, Wwr, Gg^Ve, Kvr, Gg^Efm, Gg, Gs, Gs, Gs, Hh^Fms, Gs^Fms, Ss, Ss, Gll, Ds, Ww, Ds, Gg, Gg, Hh, Hh, Gg^Em, Gs^Fms, Gll^Fmf, Gg, Gg, Gs^Fms, Gs^Fms
Gs^Fms, Ss, Ss, Gg, Gs^Fms, Gg, Gg, Ss, Gs^Fms, Gg, Gg, Gg, Gg, Gg, Ds, Ds, Ww, Cvr^Efm, Gg^Efm, Gg^Efm, Gg, Gs, Ss, Ss, Hh^Fms, Gd, Gll, Gll^Edt, Gll^Edt, Ds, Ww, Ds, Ds, Gg, Gg, Hh, Gg, Gs^Fms, Gll^Fmf, Gg, Gs^Fms, Gs^Fms, Gs^Fms
Gs^Fms, Gs^Fms, Gg, Gg, Gs^Fms, Gs^Fms, Gg, Ss, Gs^Fms, Gg, Gg, Gg, Gg, Ds, Ww, Ww, Ds, Ds, Gg, Gg, Gg, Ss, Ss, Gs^Fms, Gs^Fms, Gd, Gll^Fms, Gll^Edt, Re, Ds, Ds, Ww, Ww, Ds, Ds, Gg, Gg, Hh^Fms, Hh^Fms, Gg, Gg, Gs^Fms, Gs^Fms
Gg, Gg, Gg, Gg, Gs, Gs^Em, Gg, Gs^Fms, Gg, Gg, Gg, Gg, Ds, Ds, Wwr, Ds, Gg, Gg, Ss, Gg, Gs^Fms, Gg, Gs, Gs^Fms, Gll, Gll, Re^Edt, Re, Cer, Re, Re, Ds, Ds, Ww, Ww, Ds, Gg, Gg^Em, Gg, Gg, Gs^Fms, Gs^Fms, Gs^Fms
Hh, Hh, Gg, Gg, Gs, Gg, Gg, Gg, Gg, Gg, Ds, Ds, Ww, Ww, Ww, Ds, Gg, Gg, Ss, Gs^Fms, Gs^Fms, Gs, Gll^Edt, Gll, Gll^Fms, Re^Edt, Re, Cer, Ker, Cer, Re^Es, Gll, Gll^Edt, Ds, Wwr, Ds, Gs, Gg, Gg, Gg, Gs^Fms, Gs^Fms, Gll^Fmf
Hh, Gg, Gs^Fms, Gs^Fms, Gs^Fms, Gs, Gg, Gg, Ds, Ds, Ww, Ww, Ds, Ww, Ww, Ds, Gg, Gg, Gg, Gs^Fms, Gs, Gll^Vct, Gll^Es, Gll, Gll^Fms, Gll, Re^Es, Cer, Cer, Cer, Re^Edt, Gll, Gs^Fms, Ds, Wwr, Ds, Gs, Gs, Gg, Gs^Fms, Gs^Fms, Gll^Fmf, Gs^Fms
Gg, Gg, Gs^Fms, Gs^Fms, Gs, Gs, Gs, Gg, Ds, Ww, Ww, Ds, Ds, Ww, Ww, Ds, Ds, Gg, Gg, Gg^Em, Gg^Fms, Gg^Fms, Ss, Gd, Gd, Gll, Gll, Re, Re, Re, Gll^Edt, Gll, Gs^Fms, Ds, Ww, Ds, Ds, Gs, Gg, Gg^Em, Hh, Gs^Fms, Gs^Fms
Gg, Gg, Gg, Gs^Fms, Gs, Gg, Ds, Ds, Wwr, Wwr, Ds, Ds, Gg, Ds, Ds, Wwr, Wwr, Ds, Ds, Gg, Gg^Fms, Ss, Ss, Ss, Gs, Gll^Edt, Gd^Edt, Gll^Fms, Hh^Fmf, Gll^Fms, Gll^Edt, Gll^Fms, Gs^Fms, Ds, Ds, Ww, Ww, Ds, Ds, Gg, Hh, Hh, Gg^Efm
Hh, Gg, Gg, Gs, Ds, Ds, Ww, Ww, Ds, Ds, Gs, Gg, Gg, Gg, Gg, Ds, Ww, Ww, Ds, Gg, Hh^Fms, Gll^Fmf, Gg, Gg, Gs, Gd, Gs, Hh, Gs, Gll, Gll^Vct, Gll^Es, Gs, Gg, Gg, Ds, Ds, Ww, Ds, Gg, Gs^Fms, Gg^Efm, Gs^Fms
Hh, Hh, Ds, Ds, Wwr, Ww, Ww, Ds, Gg, Gs, Gs, Gs, Gs^Fms, Gg, Gg, Ds, Ww, Ww, Ds, Gg, Gg, Gg, Gg, Gg, Ss, Ss, Ss, Gs, Gs, Gs, Gs, Gs, Gs, Gg, Gg, Gg, Ds, Wwr, Ds, Gg, Gg, Gs^Fms, Gs^Fms
Ds, Ds, Ww, Wwr, Ds, Wwr, Ds, Ds, Gg, Gs, Gs^Efm, Gs, Gs^Fmf, Gs^Fmf, Gg^Em, Ds, Ww, Ds, Ds, Gg, Gg, Gg, Gg, Gg^Fms, Ss, Ss, Ss, Gs, Hh, Hh^Fms, Gs, Gs, Ss, Ss, Gs^Fms, Gg, Ds, Wwr, Ww, Ds, Gg, Gs^Fms, Gs^Fms
Ds, Ww, Ds, Ds, Gg, Ds, Gg, Gg, Gs, Gs, Gd^Vhr, Gg, Hh^Fms, Hh^Fmf, Gs^Fms, Ds, Ds, Ww, Ds, Gg, Gg, Gg, Gg, Gg^Fms, Gs^Fms, Gs^Fms, Gs^Fms, Gs, Gs^Fms, Hh^Fmf, Gs, Gs, Ss, Gs^Fmf, Gs^Fms, Gg, Gg, Ds, Ww, Ds, Ds, Hh, Gg
Ww, Ww, Ds, Gg, Gs, Gg, Hh, Gg^Em, Gs^Fms, Gs^Fmf, Hh^Fms, Gg, Gs^Fms, Hh^Fms, Gs^Fmf, Gg, Ds, Wwr, Ds, Gg, Gs^Fmf, Hh^Fms, Hh, Gg, Gs, Gs^Fms, Gg, Gs, Gg, Gs^Fms, Gs, Gs, Gg, Gs^Fms, Gg, Gg^Em, Gg, Ds, Ds, Wwr, Wwr, Ds, Ds
Ds, Ds, Gg, Gs, Gs, Gs, Hh, Gg^Efm, Gs^Fms, Hh^Fmf, Hh^Fms, Gs, Gs^Efm, Hh^Fmf, Gs^Fms, Gg, Ds, Wwr, Ds, Gg, Gg, Gs^Fms, Gg, Gg, Gs, Gs, Gs, Gs, Gs, Gs, Gll, Gs, Gs, Gs, Hh, Gg, Hh^Fms, Hh, Gg, Ds, Ds, Ww, Ds
Gg, Gg, Gg^Efm, Gs, Gs, Hh, Gg, Gg^Efm, Gs^Fms, Hh^Fms, Gg, Gg, Gs, Gs, Gs, Gg, Ds, Ww, Ww, Ds, Gg, Gg, Gs, Gs, Hh, Hh, Gll, Gll, Gll^Es, Gll, Uue, Gll, Gll^Es, Hh, Gs, Gs, Gs^Fms, Hh^Fms, Gs^Fms, Gg, Ds, Ww, Ww
Gs^Fms, Gs^Fms, Gs^Fms, Hh^Fms, Hh^Fmf, Gs, Hh^Fms, Gg, Gg, Gg, Gg, Gg, Gs^Efm, Gs, Gs, Gg, Ds, Ww, Ww, Ds, Gg, Gg, Gs, Gs, Gll^Es, Gll^Es, Xue, Uue, Xue, Xue, Uue^Ii, Xue, Xue, Gll^Es, Gll, Gs, Gs^Fmf, Gs^Fmf, Gs, Gg, Gg^Efm, Ds, Ds
Gs^Fms, Gs^Fms, Gs^Fmf, Hh^Fms, Hh^Fms, Hh, Hh, Gg, Gg, Gg, Hh^Fms, Gs^Efm, Gs^Fms, Gs, Gg, Gg, Ds, Ww, Ww, Ds, Gg, Hh, Hh, Gll, Xue, Xue, Uh^Vu, Xue, Uh, Uh^Ii, Uh, Uue^Ii, Uue, Xue, Xue, Gll, Gll, Gs, Gs, Gs, Gg^Fms, Gg^Fms, Gg^Fmf
Gg, Gs^Fmf, Hh^Fmf, Gs^Fms, Gs^Fms, Hh^Fms, Gs^Fmf, Gs^Fms, Gs^Fms, Gg, Hh^Fmf, Hh^Fms, Gs^Fmf, Gs^Fmf, Gg, Ds, Wwr, Wwr, Ds, Ds, Gg, Hh, Gs, Gll^Es, Uue, Xue, Uh, Re^Es, Re^Es, Re^Vu, Re^Es, Re^Es, Uh, Uh^Vu, Xue, Xue, Gll, Gs, Gs, Hh^Fms, Hh^Fms, Gg^Fmf, Gg^Fmf
Gll^Fmf, Hh^Fmf, Hh^Fms, Gs^Fms, Hh^Fms, Hh^Fmf, Gs^Fmf, Gs^Fms, Gs^Fms, Gg, Gg, Gs^Fms, Gd^Vhr, Gg^Em, Gg, Ds, Wwr, Ds, Gg, Gg, Gs^Fms, Gs, Hh, Gll, Uue, Xue, Re^Ii, Uue, Re^Ii, Uue, Cte, Re^Ii, Re^Es, Uue, Xue, Uue, Gll, Gs, Gs, Hh, Gs, Gg^Fmf, Gg^Fms
Gs^Fmf, Hh^Fmf, Gs^Fmf, Hh^Fms, Hh^Fms, Hh^Fmf, Gg^Efm, Gs^Fms, Gs, Gs, Gs, Gs, Gg, Gg, Ds, Ds, Ww, Ds, Gg^Efm, Gs^Fms, Ss, Gs, Gs, Hh, Gll, Uue, Uh^Ii, Re^Es, Uue, Cte, Kte, Cte, Uu, Xue, Uu, Gll^Es, Gll, Gs, Gs, Gs, Ss, Gg^Fms, Gg^Fms
Gs^Fms, Gs^Fmf, Gs^Fmf, Gs^Fms, Gs^Fms, Gs^Fms, Gg, Gs, Gg^Em, Gs, Gs^Efm, Gs^Efm, Gg, Ds, Wwr, Ww, Ds, Ds, Gg, Gs^Fms, Ss, Gs, Gs, Gll, Uue, Xue, Uh, Uh^Vu, Xue, Cte, Xue, Cte, Xue, Xue, Gll^Es, Gll, Gs, Gs, Gs, Ss, Ss, Gg^Efm, Gg^Fms
Gg, Gs^Fms, Gs, Gg^Efm, Gg, Gg, Gs, Gs, Hh^Fmf, Hh, Gs^Fms, Gg, Gg, Ds, Wwr, Wwr, Ds, Gg, Gg, Gg, Gg, Gs, Gs, Gll, Gll, Xue, Xue, Xue, Uue, Xue, Gll^Es, Xue, Gll, Gll, Gs^Fmf, Gs^Fmf, Gs, Gs, Gs^Fms, Ss, Gs^Fms, Gs^Fms, Gg^Fms
Gg, Gg^Em, Gs, Hh, Gs, Gs, Gs, Hh^Fms, Hh^Fmf, Gs^Fms, Gg, Gg, Gg, Ds, Ww, Ww, Ww, Ds, Ds, Gg, Gg, Gg^Em, Gg, Gs, Gs, Gll, Gll, Gll, Gs, Gll, Gll, Gll, Gs, Gs, Gs^Fms, Gs^Fms, Gs, Hh^Vu, Hh^Fms, Gs^Fms, Gg^Efm, Gg^Fms, Gg^Fms
Gs^Fms, Gs^Fms, Gs^Fms, Gs^Efm, Gs^Efm, Gs^Vhr, Gs, Gs^Fms, Gs^Fms, Gg, Gg, Gg, Ds, Ds, Ww, Ww, Ds, Ww, Ww, Ds, Ds, Gg, Gs^Fms, Ss, Gs^Fms, Gs, Gs, Gs, Gs, Gs, Gs, Gs, Hh, Gs, Gg, Gs, Gs, Hh, Hh, Hh^Fms, Gg^Efm, Gg^Fms, Gg^Fms
Hh^Fms, Hh^Fmf, Hh^Fmf, Hh, Hh, Gs, Gg^Efm, Gs^Fmf, Gg, Gg, Ds, Ds, Ww, Ww, Ds, Ds, Gg, Ds, Ww, Ww, Ds, Gg, Gs^Fms, Ss, Ss, Gg^Em, Gg^Em, Gs^Fms, Gs^Fms, Hh, Hh, Hh^Fds, Hh^Fds, Gg, Ss, Gg, Gs^Fms, Gg^Em, Hh^Fms, Hh, Hh^Fms, Gg^Fms, Gg^Fms
Gs^Fms, Hh^Fmf, Gs^Fms, Hh^Fms, Gs^Fmf, Gs^Fmf, Gs^Fmf, Gg, Gg^Em, Ds, Ww, Ww, Ds, Ds, Gg, Gs^Fms, Gg^Efm, Ds, Ds, Ww, Ds, Gg^Fms, Gg^Fms, Gg^Fms, Gg^Fmf, Gg^Fmf, Gg^Fmf, Gs^Fms, Gg^Fms, Gg^Efm, Hh^Fms, Hh^Fms, Hh^Fms, Gg^Efm, Ss, Ss, Gs^Fms, Gg^Fms, Gg^Fmf, Gs^Fmf, Gg^Fms, Gg^Fms, Gg^Fms
Gs^Fms, Gs^Fms, Gs^Fms, Gs^Fms, Gs^Fms, Gs^Fmf, Gs^Fms, Gg, Gg, Ds, Ww, Ds, Gs^Fms, Gs^Fms, Gs^Fms, Gs^Fms, Gs^Fms, Gg, Ds, Ww, Ds, Gg^Fms, Gg^Fms, Gg^Fms, Gg^Fms, Gg^Fmf, Gg, Gg^Fms, Gg, Gg^Fms, Gg^Fms, Gg^Fms, Gg^Fms, Gg^Fms, Gg, Gs^Fms, Gg, Gg^Fms, Gg^Fmf, Gg^Fmf, Gg^Fms, Gg^Fms, Gg^Fms
