Gg, Ww, Ww, Ww, Ww, Ww, Ww, Ww, Wo, Wo, Wo, Wo, Wo, Wo, Wo, Wo, Wo, Wo, Wo, Wo, Wo, Wo, Wo, Wo, Wo, Wo, Wo, Wo, Wo, Wo, Wo, Wo, Wo, Wo, Wo, Wo, Wo, Wo, Wo, Wo, Wo, Wo, Wo, Wo, Wo, Wo, Wo, Wo, Wo, Wo, Wo, Wo, Wo, Wo, Wo, Ww, Ww, Ww, Gg
Gg, Gg, Gg, Ww, Wwr, Ww, Wwr, Ww, Ww, Wo, Wo, Wo, Wo, Wo, Wo, Wo, Wo, Wo, Wo, Wo, Wo, Wo, Wo, Wo, Wo, Wo, Wo, Wo, Wo, Wo, Wo, Wo, Wo, Wo, Wo, Wo, Wo, Wo, Wo, Wo, Wo, Wo, Wo, Wo, Wo, Wo, Wo, Wo, Wo, Wo, Ww, Wo, Ww, Ww, Ww, Ww, Ww, Ww, Gg
Gg, Gs, Gg, Ww, Ww, Wwr, Wwr, Ww, Ww, Ww, Ww, Wo, Ww, Ww, Ww, Wo, Wo, Ww, Ww, Wo, Ww, Wo, Wo, Wo, Wo, Wo, Wo, Wo, Wo, Wo, Wo, Wo, Wo, Wo, Wo, Wo, Wo, Wo, Ww, Wo, Ww, Ww, Ww, Ww, Ww, Ww, Ww, Wo, Ww, Ww, Ww, Ww, Wwr, Wwr, Wwf, Wwf, Gg, Gg, Gs
Gg, Gg, Gg, Ww, Ww, Ww, Ww, Ww, Ww, Ww, Ww, Ww, Ww, Ww, Wwr, Ww, Ww, Ww, Ww, Ww, Ww, Ww, Ww, Wo, Wo, Wo, Wo, Wo, Wo, Wo, Wo, Wo, Wo, Wo, Wo, Wo, Ww, Ww, Ww, Ww, Ww, Ww, Ww, Ww, Wwr, Ww, Ww, Ww, Ww, Ww, Ww, Ww, Wwr, Wwr, Gg, Gg, Gg, Gg, Gg
Gs^Fms, Gs, Gs, Gg, Gg, Ww, Ww, Ww, Ww, Ww, Ww, Wwf, Wwf, Ww, Wwr, Ww, Wwf, Ww, Ww, Wwr, Wwr, Ww, Ww, Wo, Wo, Wo, Ww, Wo, Wo, Wo, Wo, Wo, Ww, Wo, Ww, Wo, Ww, Ww, Wwr, Wwr, Ww, Ww, Wwf, Ww, Wwr, Ww, Wwf, Wwf, Ww, Ww, Ww, Ww, Ww, Wwr, Gg, Gs, Gg, Gg, Gs
Gs^Fms, Gs^Fms, Hh, Gs, Gg, Wwf, Ww, Wwf, Wwf, Wwf, Ww, Ww, Ww, Ww, Wwr, Ww, Ww, Wwf, Ww, Wwf^Vm, Ww, Ww, Ww, Ww, Ww, Ww, Ww, Wo, Wo, Wo, Wo^Vm, Wo, Ww, Ww, Ww, Ww, Ww, Ww, Ww, Wwf^Vm, Ww, Wwf, Ww, Ww, Wwr, Ww, Ww, Ww, Ww, Wwf, Wwf, Wwf, Ww, Ww, Gg, Gg, Gs, Gs, Hh
Hh, Hh^Fms, Hh, Gs, Gg, Gg, Wwf, Ww, Ww, Wwf, Ww, Wwf, Wwf, Ww, Wwr, Ww, Wwf, Wwf, Wwr, Ww, Wwf, Ww, Ww, Ww, Ww, Ww, Ww, Ww, Ww, Wo, Ww, Ww, Ww, Ww, Ww, Ww, Ww, Ww, Wwf, Ww, Wwr, Wwf, Wwf, Ww, Wwr, Ww, Wwf, Wwf, Ww, Wwf, Ww, Ww, Wwf, Wwf, Gg, Gg, Gs, Hh, Hh
Hh, Hh, Gs, Gs, Gd^Vht, Gg, Gs, Ww, Ww, Ww, Ww, Wwf, Wwf, Ww, Ww, Ww, Ww, Wwf, Wwr, Wwr, Wwf, Ww, Ww, Ww, Ww, Wwr, Wwf, Ww, Ww, Ww, Ww, Ww, Wwf, Wwr, Ww, Ww, Ww, Ww, Wwf, Wwr, Wwr, Wwf, Ww, Ww, Ww, Ww, Wwf, Wwf, Ww, Ww, Ww, Wwf, Gg, Gg, Gg, Gs, Gs, Gs, Hh
Gg, Gs, Gd, Gd, Gd, Gs, Gs, Wwf, Ww, Wwf, Ww, Wwf, Ww, Wwr, Wwr, Ww, Wwf, Ww, Ww, Wwr, Wwf, Wwf, Ww, Wwf, Ww, Wwr^Vm, Wwf, Wwr, Wwr, Ww, Wwr, Wwr, Wwf, Wwr^Vm, Ww, Wwf, Ww, Wwf, Wwf, Wwr, Ww, Ww, Wwf, Ww, Wwr, Wwr, Ww, Wwf, Ww, Wwf, Ww, Wwf, Gd^Vht, Gs, Gs, Gs, Gs, Gs, Gs
Gg, Gs, Gd, Gd, Ket, Gd, Gs, Wwf, Ww, Wwf, Ww, Ww, Wwf, Wwf, Ww, Wwf, Wwf, Ww, Ww, Wwf, Wwf, Ww, Wwf, Wwf, Ww, Wwf, Wwr, Wwf, Cm, Ww, Cm, Wwf, Wwr, Wwf, Ww, Wwf, Wwf, Ww, Wwf, Wwf, Ww, Ww, Wwf, Wwf, Ww, Wwf, Wwf, Ww, Ww, Wwf, Ww, Gs, Gs, Gd, Ket, Gd, Gd, Gs, Gs
Gs^Fms, Gd, Gd, Ket, Ket, Ket, Gs, Wwf, Ww, Wwf, Ww, Wwf, Wwf, Wwf, Ww, Wwf, Wwf, Ww, Wwr, Ww, Ww, Ww, Wwf, Ww, Wwr, Wwr, Wwf, Cm, Km, Wwr, Km, Cm, Wwf, Wwr, Wwr, Ww, Wwf, Ww, Ww, Ww, Wwr, Ww, Wwf, Wwf, Ww, Wwf, Wwf, Wwf, Ww, Wwf, Ww, Gs, Gd, Ket, Ket, Ket, Gd, Gd, Gs
Gs^Fms, Gs, Gd, Ket, Ket, Ket, Gs, Wwf, Ww, Ww, Wwf, Ww, Ww, Ww, Ww, Ww, Wwf, Ww, Wwr, Wwr, Ww^Vm, Ww, Wwr, Ww, Wwr, Wwf, Wwr, Cm, Cm, Wwr, Cm, Cm, Wwr, Wwf, Wwr, Ww, Wwr, Ww, Ww^Vm, Wwr, Wwr, Ww, Wwf, Ww, Ww, Ww, Ww, Ww, Wwf, Ww, Ww, Wwf, Gs, Ket, Ket, Ket, Gd, Gd, Gs
Gs^Fms, Gs^Fms, Gs, Gd, Gd, Gd, Gd^Vht, Wwf, Ww, Wwf, Ww, Ww, Wwf, Wwf, Wwr, Ww, Ww, Ww, Ww, Wwr, Ww, Wwr, Wwr, Ww, Ww, Wwr, Wwf, Wwf, Wwr, Ww, Wwr, Wwf, Wwf, Wwr, Ww, Ww, Wwr, Wwr, Ww, Wwr, Ww, Ww, Ww, Ww, Wwr, Wwf, Wwf, Ww, Ww, Wwf, Ww, Wwf, Gs, Gd, Gd, Gd, Gs, Gs, Gg
Gs^Fms, Gs^Fms, Gg, Gs, Gs, Gd, Gs, Gs, Ww, Ww, Wwf, Ww, Wwf, Wwf, Wwf, Wwr, Ww, Ww, Wwf, Ww, Wwf, Wwf, Ww, Wwf, Wwf, Ww, Wwr, Wwf, Ww, Ww, Ww, Wwf, Wwr, Ww, Wwf, Wwf, Ww, Wwf, Wwf, Ww, Wwf, Ww, Ww, Wwr, Wwf, Wwf, Wwf, Ww, Wwf, Ww, Ww, Wwf, Gg, Gd^Vht, Gd, Gs, Gs, Gs, Gg
Gg, Gs, Gs, Gg, Gg, Gg, Gg, Gg, Ww, Wwf, Wwf, Ww, Ww, Wwf, Ww, Ww, Wwf, Wwf, Wwr, Ww, Ww, Ww, Ww, Wwf, Ww, Ww, Wwr^Vm, Wwr, Wwf, Ww, Wwf, Wwr, Wwr^Vm, Ww, Ww, Wwf, Ww, Ww, Ww, Ww, Wwr, Wwf, Wwf, Ww, Ww, Wwf, Ww, Ww, Wwf, Wwf, Ww, Wwf, Gg, Gg, Gs, Gs, Gs, Gg, Gs^Fms
Gs, Gs, Hh, Gs, Gs, Gg, Gg, Wwf, Ww, Ww, Ww, Ww, Wwf, Ww, Ww, Wwr, Wwf, Wwf, Ww, Ww, Wwf, Wwf, Ww, Wwf, Ww, Wwf, Wwr, Wwf, Ww, Ww, Ww, Wwf, Wwr, Wwf, Ww, Wwf, Ww, Wwf, Wwf, Ww, Ww, Wwf, Wwf, Wwr, Ww, Ww, Wwf, Ww, Ww, Ww, Ww, Gg, Gg, Gg, Gg, Gs, Gs, Gs^Fms, Gs^Fms
Gs, Gs, Hh, Hh, Gs, Gg, Gg, Wwf, Ww, Wwf, Ww, Wwf, Wwf, Wwf, Ww, Wwr, Ww, Ww, Ww, Wwf, Wwf, Wwf, Wwr, Ww, Wwf, Wwr, Ww, Ww, Wwr, Wwf, Wwr, Ww, Ww, Wwr, Ww, Ww, Wwr, Wwf, Wwf, Wwf, Ww, Ww, Ww, Wwr, Ww, Wwf, Wwf, Wwf, Ww, Wwf, Ww, Gg, Gg, Gg, Gs, Gs^Fms, Gg, Gs^Fms, Gg
Gs, Gs, Hh, Hh, Gs, Gg, Gg, Wwf, Ww, Wwf, Wwf, Ww, Wwf, Ww, Wwr, Wwf, Ww, Wwf, Wwr, Wwr, Wwf, Wwr, Ww, Ww, Ww, Wwf, Ww, Ww, Ww, Ww, Ww, Ww, Wwf, Wwf, Ww, Ww, Ww, Wwr, Wwf, Wwr, Wwr, Wwf, Ww, Wwf, Wwr, Ww, Wwf, Ww, Wwf, Wwf, Ww, Gg, Gg, Gg, Gg, Gs, Gg, Gg, Gg
Gs, Gs, Gs, Hh, Gs, Gg, Gg, Gg, Ww, Wwf, Ww, Ww, Ww, Ww, Wwr, Wwf, Ww, Wwf, Wwr, Wwr^Vm, Ww, Ww, Ww, Wwf, Wwf, Ww, Ww, Ww, Wwf^Vm, Wwf, Wwf, Ww, Ww, Ww, Wwf, Wwf, Ww, Ww, Ww, Wwr^Vm, Wwr, Wwf, Ww, Wwf, Wwr, Ww, Ww, Ww, Ww, Wwf, Ww, Wwf, Gg, Gg, Gs, Gs, Gs, Gs, Gs
Gs, Gs, Gs, Gs, Gs, Gg, Gg, Gg, Ww, Ww, Wwr, Ww, Wwr, Wwr, Wwf, Wwf, Wwf, Wwf, Ww, Ww, Wwr, Ww, Ww, Wwf, Ww, Ww, Wwr, Wwr, Wwf, Wwr, Ww, Wwr, Wwr, Ww, Ww, Wwf, Ww, Ww, Wwr, Ww, Ww, Wwf, Wwf, Wwf, Wwf, Wwr, Wwr, Ww, Wwr, Ww, Ww, Wwf, Gg, Gs, Hh, Hh, Gs, Gs, Gs
Gg, Gs, Gs, Gg, Gg, Gg, Gg, Gg, Ww, Ww, Ww, Ww, Ww, Ww, Ww, Ww, Ww, Wwf, Ww, Wwr, Wwr, Ww, Ww, Ww, Ww, Ww, Wwr, Wwr, Ww, Ww, Ww, Wwr, Wwr, Ww, Ww, Ww, Ww, Ww, Wwr, Wwr, Ww, Wwf, Ww, Ww, Ww, Ww, Ww, Ww, Ww, Ww, Ww, Wwf, Gg, Gs, Hh, Hh, Gs, Gs, Gs
Gg, Gg, Gs^Fms, Gg, Gg, Gg, Gg, Gg, Ww, Wwf, Wwf, Ww, Wwr, Ww, Ww, Ww, Ww, Ww, Ww, Ww, Ww, Wwr, Ww, Wwf, Wwf, Ww, Ww, Ww, Ww, Ww, Ww, Ww, Ww, Ww, Wwf, Wwf, Ww, Wwr, Ww, Ww, Ww, Ww, Ww, Ww, Ww, Ww, Wwr, Ww, Wwf, Wwf, Ww, Wwf, Wwf, Gs, Gs, Hh, Gs, Gs, Gs^Fms
Gg, Gg, Gs^Fms, Gs^Fms, Gg, Gg, Gg, Wwf, Ww, Ww, Wwf, Ww, Ww, Ww, Wwr, Wwr, Ww, Ww, Wwf, Ww, Ww, Ww, Ww, Ww, Wwf, Ww, Ww, Wwf, Wwf, Wwr, Wwf, Wwf, Ww, Ww, Wwf, Ww, Ww, Ww, Ww, Ww, Wwf, Ww, Ww, Wwr, Wwr, Ww, Ww, Ww, Wwf, Ww, Ww, Wwf, Gg, Gg, Gg, Gs, Gg, Gs^Fms, Gs^Fms
Gg, Gg, Gg, Gg, Gs, Gg, Gg, Wwf, Ww, Ww, Ww, Ww, Wwr, Wwr, Ww, Ww, Ww, Wwr, Wwf, Ww, Wwr, Ww, Ww, Ww^Vm, Ww, Ww, Ww, Ww, Wwr, Wwr, Wwr, Ww, Ww, Ww, Ww, Ww^Vm, Ww, Ww, Wwr, Ww, Wwr, Wwf, Ww, Ww, Ww, Wwr, Wwr, Ww, Ww, Ww, Wwf, Wwf, Gg, Gg, Gg, Gg, Gg, Gs^Fms, Gs^Fms
Gs, Gg, Gs, Gs, Hh, Gs, Gg, Wwf, Wwf, Ww, Ww, Ww, Ww, Ww, Ww, Ww, Ww, Wwf, Wwf, Ww, Wwf, Wwr, Ww, Ww, Wwf, Ww, Ww, Ww, Ww, Wwf, Ww, Ww, Ww, Ww, Wwf, Ww, Ww, Wwf, Wwf, Ww, Wwf, Wwf, Ww, Ww, Ww, Ww, Ww, Ww, Ww, Gg, Gg, Gg, Gg, Gg, Gg, Gs, Gg, Gs^Fms, Gs^Fms
Gs, Gs, Hh, Hh, Hh, Gs, Gg, Gg, Gg, Wwf, Ww, Wwf, Wwf, Ww, Ww, Ww, Ww, Ww, Ww, Ww, Wwf, Wwr, Ww, Wwr, Wwf, Wwr, Ww, Wwf, Ww, Ww, Ww, Wwr, Ww, Wwf, Wwr, Wwr, Ww, Wwr, Wwr, Ww, Ww, Ww, Ww, Ww, Ww, Ww, Wwf, Wwf, Ww, Gg, Gg, Gg, Gs, Gs, Gs, Gs, Gs, Gg, Gg
Gs, Gs, Gs, Hh, Hh, Gs, Gg, Gg, Gg, Ww, Ww, Wwr, Ww, Wwf, Ww, Ww, Ww, Ww, Ww, Ww, Ww, Ww, Ww, Ww, Ww, Wwr, Ww, Wwr, Ww, Wwr, Ww, Wwf, Ww, Wwr, Ww, Ww, Ww, Ww, Ww, Ww, Ww, Ww, Ww, Ww, Ww, Wwf, Ww, Wwr, Ww, Wwf, Gg, Gs, Gs, Gs, Gs, Gs, Gs, Gg, Gg
Gg, Gs, Gs, Gs, Gs, Gs, Gg, Gs, Gg, Gg, Wwf, Ww, Ww, Ww, Ww, Ww, Wwr, Wwf, Wwf, Ww, Ww, Wwr, Ww, Ww, Ww, Ww, Ww, Ww, Ww, Wwr, Ww, Ww, Ww, Ww, Ww, Ww, Ww, Wwr, Ww, Ww, Ww, Wwr, Wwr, Ww, Ww, Ww, Ww, Ww, Wwf, Wwf, Gg, Gg, Gs, Gs, Gs, Gs, Gg, Gg, Gg
Gg, Gs, Gs, Gs, Gg, Gs, Gg, Gs, Gg, Gg, Gg, Gg, Gg, Ww, Wwf, Ww, Wwr, Ww, Wwr, Ww, Ww, Wwr, Wwf, Ww, Wwf, Ww, Ww, Ww, Wwf, Ww, Wwr, Ww, Ww, Ww, Wwf, Ww, Wwf, Wwr, Ww, Ww, Ww, Wwf, Wwr, Ww, Wwf, Ww, Gg, Gg, Gg, Gg, Gg, Gs, Gs, Gs, Gg, Gg, Gg, Gg, Gg
Gg, Gs, Gg, Gg, Gs, Gg, Gg, Gg, Gs, Gs, Gg, Gg, Wwf, Ww, Ww, Ww, Ww, Wwr, Ww, Ww, Wwf, Ww, Ww, Wwf, Ww, Ww, Ww, Ww, Wwr, Wwr, Wwr, Ww, Ww, Ww, Wwf, Wwf, Ww, Ww, Wwr, Ww, Ww, Wwr, Ww, Ww, Ww, Ww, Wwf, Gg, Gg, Gg, Gg, Gg, Gs, Gs, Gs, Gg, Gg, Gg, Gg
Gg, Gg, Gs, Gs, Gs^Fms, Gs^Fms, Gg^Fms, Gg, Gg, Gg, Gg, Gg, Wwf, Ww, Ww, Wwr, Ww, Ww, Ww, Ww, Ww, Ww, Ww, Ww, Wwf, Ww, Wwf, Wwr, Wwr, Wwf, Wwf, Wwr, Wwf, Ww, Ww, Ww, Ww, Ww, Ww, Ww, Ww, Ww, Ww, Wwr, Ww, Ww, Gg, Gg, Gs, Gg, Gg, Gg, Gs, Hh, Hh, Gs, Gg, Gs, Gg
Gg, Gg, Gg, Gs, Hh^Fms, Gs^Fms, Gs^Fms, Gg, Gg, Gg, Gg, Gg, Gg, Ww, Ww, Ww, Ww, Ww, Ww, Wwr, Wwr, Ww, Ww, Wwf, Wwf, Ww, Ww, Wwf, Ww, Wwr, Ww, Ww, Ww, Ww, Wwf, Wwf, Ww, Ww, Ww, Wwr, Ww, Ww, Ww, Ww, Ww, Ww, Gg, Gg, Gs, Gs, Gg, Gs, Hh, Hh, Gs, Gs, Gg, Gs, Gg
Gg, Gs, Gg, Gs, Hh, Hh^Fms, Gs, Gg, Gg, Gg, Gg, Gg, Gg, Gg, Gg, Gg, Wwf, Ww, Ww, Ww, Ww, Ww, Ww, Ww, Wwr, Ww, Ww, Ww, Ww, Ww, Ww, Ww, Ww, Ww, Wwf, Wwr, Ww, Ww, Wwr, Ww, Ww, Ww, Wwf, Wwf, Gg, Gg, Gg, Gg, Gs, Gg, Gs, Gs, Gs, Gs, Gg, Gg, Gg, Gs, Gg
Gs, Gg, Gg, Gs, Gs, Hh, Gs, Gg, Gs, Gs, Gs, Gs, Gs, Gg, Gg, Gg, Wwf, Wwf, Wwf, Ww, Ww, Ww, Ww, Ww, Ww, Ww, Ww, Ww, Ww, Ww, Wwf, Ww, Ww, Ww, Ww, Ww, Ww, Ww, Ww, Ww, Wwf, Wwf, Gg, Gg, Gs, Gg, Gg, Gs, Gs, Gs, Gs, Gs, Gs, Gs, Gg, Gg, Gg, Gs, Gg
Gs, Gs, Gg, Gs, Gs, Gs, Gs, Gg, Gs, Hh, Hh, Hh, Gs, Gg, Gg, Gg, Gg, Wwf, Gg, Gg, Ww, Ww, Ww, Wwr, Wwr, Ww, Ww, Wwr, Wwf, Wwf, Wwr, Wwr, Ww, Ww, Wwr, Wwr, Ww, Ww, Ww, Wwf, Gg, Gg, Gg, Gg, Gs, Gs, Gg, Gs, Hh, Gs, Gs, Gs, Gs, Gg, Gg, Gg, Gg, Gs^Fms, Gs^Fms
Gs, Gs, Gg, Gg, Gs^Fms, Gs^Fms, Gs, Gs, Gs, Hh, Gs, Gs, Gg, Gs, Gg, Gg, Gg, Gg, Gg, Gg, Gg, Ww, Ww, Ww, Ww, Ww, Ww, Ww, Ww, Ww, Ww, Ww, Ww, Ww, Ww, Ww, Ww, Ww, Wwf, Gg, Gg, Gg, Gs, Gg, Gs, Gg, Gg, Gs, Hh, Hh, Gs, Gs, Gs, Gg, Hh, Hh, Hh^Fms, Gs^Fms, Gs^Fms
Gg, Gg, Gg, Gg, Gs^Fms, Gs^Fms, Gg, Gs, Gs, Gg, Gg, Gg, Gg, Gs, Gs, Gs, Gg, Gg, Gg, Gg, Gg, Wwf, Wwf, Wwf, Gg, Ww, Ww^Vhs, Ww, Ww, Ww, Ww, Ww, Wwr, Ww, Gg, Wwf, Gg, Gg, Gg, Gs, Gs, Gg, Gg, Gg, Gg, Gg, Gs^Fms, Gs, Gs, Gs, Gs, Gs, Gs, Gg, Hh, Hh^Fms, Gs^Fms, Gs^Fms, Gs^Fms
Gg, Gg, Gs, Gs, Gs, Gs, Gs, Gg, Gs, Gg, Gs, Gg, Gs, Gg, Gs, Gs, Gs, Gs, Gs, Gs, Gg, Gg, Gg, Gg, Gg, Gg, Wwr, Wwr, Cme, Cme, Cme, Wwr, Wwf^Vhs, Gg, Gg, Gg, Gg, Gg, Gg, Gg, Gg, Gg, Gg, Gg, Gg, Gs^Fms, Gs^Fms, Gs^Fms, Gg, Gg, Gg, Gs, Gg, Gg, Gg, Hh, Gg, Gs^Fms, Gg
Gg, Gs, Gs, Gs, Gs, Hh, Hh, Gs, Gs, Gs^Fms, Gs^Fms, Gg, Gs, Gg, Gs, Gs, Gg, Gg, Hh, Gg, Gg, Gg, Gg, Gs, Gs, Gg, Wwf, Ww, Cme, Kme, Cme, Ww, Wwf, Gg, Gg, Gg, Gs, Gg, Gg, Gg, Gg, Gg, Gs, Gg, Gs, Gs^Fms, Gg, Gs, Gg, Gs, Gg, Gs, Gs, Gg, Gg, Gg, Gs, Gs, Gg
Gs^Fms, Gs, Gg, Gs, Gs, Hh, Gs, Gs, Gs^Fms, Gs^Fms, Gs^Fms, Gg, Gg, Gs, Gs, Gg, Gg, Hh, Hh, Gg, Gs, Gs, Gs, Gs, Gg, Gg, Gs, Wwr, Wwr, Cme, Wwr, Wwr, Gg, Gs, Gs, Gs, Gs, Gg, Gs^Fms, Gg, Gg, Gs, Gg, Gg, Gg, Gg, Gg, Gg, Hh, Gs, Gs, Gg, Gs^Fms, Gs^Fms, Gg, Gs, Gs^Fms, Gg, Gs^Fms
Gs^Fms, Gs^Fms, Gs^Fms, Gg, Gg, Gs, Gg, Gs, Hh, Hh^Fms, Hh, Gs^Fms, Gg, Gs, Gg, Gs, Hh, Hh, Hh, Gg, Gg, Gs, Gg, Gs, Gg, Gg, Gg, Gs, Gs, Wwr, Gs, Gg, Gg, Gg, Gg, Gg, Gs, Gs^Fms, Gs^Fms, Gg, Gg, Gg, Gg, Gg, Gg, Gs, Gs, Hh, Hh, Gg, Gg, Gs, Gs^Fms, Gs^Fms, Gs^Fms, Gs^Fms, Gs^Fms, Gg, Gs^Fms
Gs^Fms, Gs^Fms, Gs^Fms, Gg, Gg, Gg, Gg, Gs, Gs, Hh, Gs, Gs, Gg, Gs, Gg, Gg, Gg, Hh, Gg, Gg, Gg, Gg, Gg, Hh, Hh, Gg, Gg, Gg, Gs, Gs, Gs, Gg, Gg, Gg, Gg, Gg, Gg, Gs^Fms, Gs^Fms, Gs^Fms, Gs, Gs, Gg, Gs, Gs^Fms, Gg, Gg, Hh, Hh, Gg, Gg, Gg, Gs^Fms, Gs^Fms, Gs^Fms, Gs^Fms, Gs^Fms, Gs^Fms, Gs^Fms
Gs^Fms, Gs^Fms, Gs^Fms, Gs^Fms, Gg, Gg, Gg, Gg, Gg, Gs, Gg, Gg, Gg, Gg, Gg, Gg, Gg, Gg, Gg, Gg, Gg, Gg, Gg, Hh, Hh, Hh, Gg, Gs, Gs, Gs, Gg, Gg, Gg, Gg, Gg, Gg, Gg, Gs^Fms, Gg, Gg, Gg, Gg, Gg, Gs^Fms, Gs^Fms, Gs^Fms, Gs^Fms, Gg, Gg, Gg, Gg, Gs^Fms, Gs^Fms, Gs^Fms, Gs^Fms, Gs^Fms, Gs^Fms, Gs^Fms, Gs^Fms
