Gs^Fms, Gs^Fms, Gg, Gg, Gg, Gg, Gs^Fms, Gs^Fms, Gg, Gg, Gg, Gg, Gs^Fms, Gg, Gg, Gg, Gs^Fms, Gg, Gg, Gg, Gs^Fms, Gs^Fms, Gs^Fms, Gg, Gs, Gs^Fms, Gs^Fms, Gg, Gg, Gg, Gs^Fms, Gs^Fms, Gs, Gs, Gs, Gs^Fms, Gs^Fms, Gg, Gs, Gg, Gg, Gg, Wwt, Gg, Gg, Gs^Fms, Gs^Fms, Gg, Gs, Gg, Gs, Gs^Fms, Gs^Fms, Gg, Gg, Gg
Gs^Fms, Gs^Fms, Gs^Fms, Gg, Gs^Fms, Gs^Fms, Gs^Fms, Gg, Gs^Fms, Gg, Re, Gs, Gs^Fms, Gg, Gs, Gs^Fms, Gs, Gs^Fms, Gs^Fms, Gs, Gs^Fms, Gs^Fms, Gg, Gs^Fms, Gs, Gg, Gs^Fms, Gs^Fms, Gs^Fms, Gs^Fms, Gs^Fms, Gs^Fms, Gs^Fms, Gs, Gs, Gs^Fms, Gs, Gs^Fms, Gs, Gg^Fms, Wwrt, Wwt, Gg^Fms, Gs, Gs^Fms, Gs^Fms, Gs, Gs^Fms, Gs^Fms, Gs, Gs^Fms, Gs^Fms, Gs^Fms, Gs^Fms, Gs^Fms, Gg
Wwt, Gg, Gg, Gs, Gs, Gs^Fms, Gs, Gs^Fms, Ss, Gs^Fms, Re^Edt, Re^Vht, Ss, Gs^Fms, Re^Vht, Gs^Fms, Gs, Gs^Fms, Gs^Fms, Gs, Gs^Fms, Gs, Gg, Gs^Fms, Gs, Gs^Fms, Gs, Gs, Gs^Fms, Gs, Gs^Fms, Gg, Gs^Fms, Gs^Fms, Gs, Gs, Gg^Fms, Gs, Gg, Gg^Fms, Wwrt, Gg^Fms, Gg^Fms, Gs, Gs^Fms, Ss, Gs, Gs, Gs^Fms, Gs, Gs^Fms, Gs^Fms, Gg, Ss, Gg, Gs^Fms
Gg, Wwt, Wwt, Gg, Gs^Fms, Gs, Gs^Fms, Gs, Gd^Vht, Re, Ce, Ce, Ce, Re, Re^Edt, Gs^Fms, Ss, Gs^Fms, Gs^Fms, Gs^Fms, Gs^Fms, Ss, Gs^Fms, Gs^Fms, Gs^Fms, Gs^Fms, Gs^Fms, Ss, Gg, Gs^Fms, Gs^Fms, Ss, Gg, Gs^Fms, Wwrt, Wwt, Wwt, Wwrt, Wwt, Wwt, Gg, Wwt, Wwt, Gs, Gg, Gs, Gg, Gs, Gs^Fms, Ss, Gs^Fms, Gs^Fms, Gs^Fms, Gs^Fms, Gs^Fms, Gs^Fms
Gg, Gg, Wwt, Gg, Gg, Gs^Fms, Gs^Fms, Gd, Gd^Edt, Re^Edt, Ce, Ke, Ce, Re^Vht, Re^Edt, Gd^Edt, Re^Dr, Gs, Gg^Fms, Gg, Gg, Gs^Fms, Gs^Fms, Gs, Gs^Fms, Gs^Fms, Gs^Fms, Gg, Gg, Gg, Wwrt, Gg, Wwt, Wwt, Gg, Gg, Gg, Gg, Gs^Fms, Gg, Gg, Gg, Gg, Wwt, Wwrt, Wwrt, Wwrt, Gs^Fms, Gs^Fms, Gs^Fms, Gs^Fms, Gs, Gs^Fms, Gs^Fms, Ss, Gs^Fms
Gs^Fms, Gs^Fms, Gg, Wwrt, Wwt, Gg, Re^Dr, Re^Edt, Re, Re^Edt, Ss, Ce, Re^Edt, Ss, Gs^Fms, Re^Dr, Wwt, Wwt, Wwt, Wwrt, Wwt, Gg^Fms, Gg, Gs^Fms, Ss, Gs, Gg^Fms, Gs^Fms, Wwt, Wwrt, Gg, Wwt, Gg^Fms, Gg, Gg, Gs^Fms, Gs^Fms, Gs, Gs^Fms, Ss, Gs, Gs^Fms, Gs, Gg, Gg, Gg^Fms, Wwt, Gg^Fms, Gg^Fms, Gs, Gs^Fms, Gs^Fms, Gs^Fms, Gs^Fms, Gs^Fms, Gg
Gg, Gs^Fms, Ss, Gg, Gg, Wwt, Wwt, Gs^Fms, Gd, Re^Dr, Re, Gd^Edt, Re^Dr, Re, Wwrt, Wwrt, Gs, Gg^Fms, Gs^Fms, Gg, Gg, Wwt, Gg, Gs^Fms, Gs, Gg, Wwt, Wwt, Gg^Fms, Gg, Gg, Gs, Ss, Gs^Fms, Gs^Fms, Gs, Gs^Fms, Gs^Fms, Gs^Fms, Gs^Fms, Gs^Fms, Gs, Gs^Fms, Ss, Gs^Fms, Gs^Fms, Gg, Wwt, Wwt, Gg^Fms, Gs, Ss, Gs^Fms, Gs, Gs^Fms, Gs^Fms
Gg, Gs^Fms, Gs^Fms, Gs^Fms, Gg, Gg, Gg, Wwrt, Wwrt, Wwt, Wwt, Gs^Fms, Wwt, Wwt, Gg, Gs, Ss, Gs^Fms, Gs^Fms, Gg, Gs, Wwrt, Wwt, Gg^Fms, Gg^Fms, Gg, Wwt, Gg, Ss, Gs^Fms, Gg, Gs^Fms, Gg, Gs^Fms, Gs^Fms, Gs, Gs, Ss, Gs, Gs, Gs^Fms, Gs^Fms, Gs^Fms, Gs, Gg, Gs^Fms, Ss, Gg, Wwrt, Gg^Fms, Gg, Gs^Fms, Gg, Gs^Fms, Gs^Fms, Gg
Gg, Gg, Gs^Fms, Gs^Fms, Gs^Fms, Gg, Gs, Gg, Gg, Gg, Gg, Wwrt, Wwt, Gg, Gs, Gs^Fms, Gs^Fms, Gs^Fms, Gs^Fms, Ss, Gs, Gs, Gg, Wwt, Wwrt, Wwrt, Wwt, Gg, Gg, Gg, Wwt, Gg, Gg, Gg, Gg^Fms, Gs, Gg, Gs^Fms, Gs^Fms, Gs, Gs, Ss, Gs, Gs^Fms, Gg, Gs^Fms, Gg^Fms, Gg, Gg, Wwrt, Gg, Gg, Gg, Ss, Gs^Fms, Gs
Gg, Gs, Ss, Gs^Fms, Gs, Gs^Fms, Gs, Gs, Gs^Fms, Gg, Gs, Gg, Gg, Wwt, Wwt, Gs^Fms, Gg, Gs, Gs, Gg, Gs, Gs, Gs, Gg, Gg, Gg^Fms, Gg^Fms, Wwt, Wwt, Wwt, Cv, Wwt, Wwt, Wwt, Wwt, Gg, Wwt, Gg, Gg, Gg, Gg^Fms, Gg, Gg, Gg, Wwrt, Wwt, Wwt, Wwrt, Wwt, Wwt, Wwt, Wwt, Wwrt, Gs^Fms, Gg, Gg
Gs^Fms, Gs^Fms, Gs^Fms, Gs^Fms, Gs, Gs^Fms, Ss, Gs, Gs, Gg, Gg, Gs, Gg, Gg, Gg, Wwrt, Wwrt, Gs, Gs, Gs^Fms, Gs^Fms, Ss, Gs^Fms, Gs, Gg, Gg^Fms, Wwt, Wwt, Cv, Cv, Gg, Cv, Cv, Cv, Cv, Wwt, Cv, Wwt, Wwt, Wwt, Wwt, Wwt, Wwt, Wwt, Gg, Gg^Fms, Gs^Fms, Gg, Gs^Fms, Gg, Gg, Gg, Gg, Wwrt, Wwt, Gg
Gs^Fms, Gg, Gs, Gs^Fms, Gg, Gs^Fms, Gs^Fms, Gs^Fms, Gs^Fms, Gs^Fms, Gg, Gs^Fms, Gs, Gg, Gs^Fms, Gg, Wwt, Gs^Fms, Ss, Gs, Gg^Fms, Gs, Gs, Gs, Wwt, Wwt, Cv, Cv, Gg, Gg, Gg, Gg, Gg, Gg, Gg, Cv, Gg, Cv, Cv, Cv, Cv, Cv, Cv, Wwt, Wwt, Gg, Gg, Ss, Gs^Fms, Gs^Fms, Gs^Fms, Gs^Fms, Gg, Gg, Gs^Fms, Wwt
Gg, Gs^Fms, Gs^Fms, Gs^Fms, Gs^Fms, Gs^Fms, Gs^Fms, Gs, Gs, Gs^Fms, Gs^Fms, Gg, Gs^Fms, Gs, Gg, Gg, Wwt, Gs^Fms, Gs^Fms, Gs^Fms, Gs^Fms, Gs, Gg, Wwt, Cv, Cv, Gg, Gg, Gs, Gg^Efm, Gs, Gg, Gg^Fms, Gg, Gs^Fms, Gs, Gg^Fms, Gg, Gg, Gg, Gg, Gg, Gg, Cv, Cv, Wwt, Wwt, Gg, Gs^Fms, Gs^Fms, Gg, Ss, Gs^Fms, Gs^Fms, Gs^Fms, Gg
Gs, Gg, Gs^Fms, Gg, Gs^Fms, Gs, Ss, Gs^Fms, Gs^Fms, Gs, Gg, Ss, Gs^Fms, Gs, Gs^Fms, Gg^Fms, Wwrt, Gg, Wwt, Gg, Gg, Gs^Fms, Gg, Wwt, Cv, Gg, Gs^Fms, Gs, Gg^Fms, Gs^Fms, Gg^Efm, Gg^Efm, Gs^Fms, Gg^Efm, Gg^Ve, Gs^Fms, Gg^Fms, Gg^Fms, Gs^Efm, Gs, Gs, Gs, Gg, Gg, Gg, Cv, Cv, Wwt, Wwt, Gg, Gg, Gs^Fms, Gg, Gs^Fms, Gg, Gs^Fms
Gs, Gs^Fms, Ss, Gg, Gs^Fms, Gs^Fms, Gs^Fms, Gs, Gg, Gs^Fms, Gg, Gs^Fms, Gg, Gs^Fms, Gs^Fms, Gg^Fms, Gg, Wwrt, Gg, Wwt, Wwt, Gg, Wwt, Wwt, Cv, Gg, Gg, Gg^Efm, Gs^Fms, Gs^Fms, Gs^Fms, Gs, Gs, Gs^Efm, Gg, Gs, Gs, Gg^Efm, Gg, Gg^Fms, Gg^Fms, Gg^Ve, Gg^Efm, Gg, Gs^Fms, Gg, Gg, Cv, Cv, Wwt, Gs^Fms, Gs^Fms, Gs^Fms, Gs^Fms, Gs, Gs^Fms
Gs^Fms, Gs^Fms, Gs^Fms, Gs, Gs^Fms, Gs, Gs^Fms, Gg, Gs^Fms, Gs^Fms, Gs^Fms, Gs^Fms, Gs, Gs^Fms, Gg^Fms, Gg, Gg, Gg, Gg, Gg^Fms, Gg^Fms, Wwrt, Gg, Wwt, Cv, Gg, Gg, Gs, Gg^Efm, Gg^Efm, Cv, Cv, Cv, Gs^Fms, Gg, Gg^Fms, Wwt, Gs, Gg^Efm, Gs^Fms, Gg, Gg^Efm, Gg^Efm, Gs^Fms, Gs^Fms, Gg, Gs^Fms, Gg, Cv, Wwt, Gg^Fms, Ss, Gs^Fms, Gs^Fms, Gg, Gg
Gs^Fms, Gs, Gg, Gg, Gs^Fms, Gs^Ve, Gs, Gs^Fms, Cv^Fms, Gs, Gs^Fms, Gs^Fms, Gs^Fms, Gs^Fms, Ss, Gs^Fms, Gg, Gs^Fms, Gs^Fms, Gg, Gg, Gg, Gg, Wwt, Cv, Gg, Gs, Gg^Ve, Gg^Efm, Gg, Cv, Kv, Cv, Gs^Fms, Gs^Efm, Wwt^Bw\, Gg^Fet, Wwt, Wwt^Ewf, Gg, Gg^Fms, Gg, Gs, Gs^Fms, Gs^Efm, Gg^Efm, Gg, Gg, Cv, Wwt, Gg, Gs, Gs^Fms, Gs, Gs^Fms, Gg
Gs, Gs^Fms, Gs^Fms, Gg, Gg, Gs^Fms, Gs^Fms, Cv^Fms, Kv^Fet, Cv^Fms, Gg, Gs, Gs^Fms, Gg, Gg, Gs^Fms, Gg, Gg, Gg, Gs^Fms, Gs^Fms, Gg^Fms, Gg^Fms, Wwt, Cv, Gg, Gg^Efm, Gs^Efm, Gg^Fms, Gs, Gs, Cv, Gs^Fms, Gg, Gg^Fms, Wwt, Wwt^Ewf, Gg^Ve, Wwt^Bw\, Gs, Cv, Cv, Cv, Gs, Gs^Efm, Gg^Ve, Gs, Gg, Cv, Wwt, Gg, Gs, Gs, Gs^Fms, Gs^Fms, Gs
Gs^Fms, Gs^Fms, Gg, Gs^Fms, Ss, Gs^Fms, Gs^Fms, Cv^Fms, Cv^Fms, Cv^Fms, Gs^Fms, Gs, Gs^Ve, Gg, Gs^Fms, Gg, Gg, Gg, Ss, Gs^Fms, Gg, Gg^Fms, Gg, Wwt, Cv, Gg, Gg, Gg^Fms, Gs^Fms, Gs^Efm, Gg, Gs, Gs^Fms, Gg^Fms, Gg^Fms, Gs^Fms, Gg, Wwt, Gg^Fms, Gs, Cv, Kv, Cv, Gs^Fms, Gg, Gs^Fms, Gg^Fms, Gg, Cv, Wwt, Gg^Fms, Gg, Gs, Ss, Gs^Fms, Gs^Fms
Gs^Fms, Gs^Fms, Gg, Gg, Gs^Fms, Gs^Fms, Gs, Gg, Gs^Fms, Gg, Gs, Gs^Fms, Gs, Gs^Fms, Gg, Gs^Fms, Gs^Fms, Gg, Gs^Fms, Gs^Fms, Gs^Fms, Gg, Gg^Fms, Wwt, Cv, Gs, Gs, Gs^Fms, Gs^Fms, Gs, Gs, Gs, Gs, Gs, Gg^Ve, Gs, Gs, Gg^Fms, Gg^Fms, Gg, Gg, Cv, Gs, Gs^Fms, Gs^Efm, Gs^Fms, Gs^Fms, Gg, Cv, Wwt, Gg, Gs^Fms, Gs^Fms, Gs^Fms, Gs, Gg
Gg, Gs^Fms, Gs^Fms, Gg, Gg, Gs^Fms, Gs^Fms, Gs^Fms, Gs^Fms, Gs^Fms, Gs^Fms, Gs^Fms, Gs^Fms, Gg, Ss, Gs, Gs^Fms, Gs^Fms, Gs^Fms, Gg, Gg, Gg, Sm, Wwg, Cv, Gs, Gs, Gs, Gs, Gs, Gs, Gs, Gs, Gs, Gs, Gs, Gs, Gg^Fms, Gs, Gs, Gs, Gg, Gg, Gg, Gg^Ve, Gg^Efm, Gg, Gg, Cv, Wwt, Gg, Gs^Fms, Gs^Fms, Gs^Fms, Gs^Fms, Gg
Gs^Fms, Gg, Gg, Gs^Fms, Gs, Gs^Fms, Gg, Gg, Gg, Gg, Gs^Fms, Gs^Fms, Gg, Gs^Fms, Gs^Fms, Gs^Fms, Gs, Gs^Fms, Gs^Fms, Gg, Gll, Sm, Xue, Xue, Xue, Gs, Xue, Gs, Xue, Xue, Xue, Xue, Xue, Xue, Xue, Xue, Xue, Gs, Xue, Gs, Gs, Gs, Gs^Fms, Gs^Fms, Gs^Fms, Gg^Efm, Gg, Gg, Cv, Wwt, Gg, Gs, Ss, Gs^Fms, Gs^Fms, Gg
Gs^Fms, Gg, Gs^Fms, Gg, Gs, Gs^Fms, Gs^Fms, Gs^Fms, Gs^Fms, Ss, Gg, Gs^Fms, Gs^Fms, Gg, Gs, Gs^Fms, Gs^Fms, Gs^Fms, Gg, Gs^Fms, Gs^Fms, Xue, Sm, Xu, Uue, Xue, Sm, Xue, Wwg, Sm, Wwf, Sm, Wwf, Sm, Wwf, Wwg, Uh, Xue, Uue^Ii, Re^Pr\, Xue, Gs, Gs, Gs^Fms, Gs, Gg, Cv, Cv, Wwt, Wwt, Gs^Fms, Gs, Gs^Fms, Gg, Gs^Fms, Gs^Fms
Gg, Gs^Fms, Gs^Fms, Ss, Gs^Fms, Gs^Fms, Gs^Fms, Gs^Fms, Gg, Gs^Fms, Gg, Gs^Fms, Gs^Fms, Gs, Gs^Fms, Gg, Gs^Fms, Gs, Gg, Gg, Gll, Xue, Wwf, Re, Re^Pr/, Xu, Re, Re, Uue, Re, Re, Re, Uh, Uue, Re, Re, Re, Re, Re, Re^Ii, Uh, Xue, Gs, Gs, Cv, Cv, Wwt, Wwt, Gg, Gg, Gg, Gs^Fms, Gs^Fms, Gg, Gg, Gg
Gs^Fms, Gs^Fms, Gg, Gg, Gs^Fms, Gg, Gs^Fms, Gs, Gs, Gs^Fms, Gs^Fms, Gg, Gs^Fms, Gg, Gs^Fms, Ss, Gs^Fms, Gs, Gs^Fms, Gg, Gs^Fms, Xue, Xu, Xu, Uue, Re, Re, Uh, Xu, Re^Pr|o, Xu, Uh, Xu, Re^Pr|, Xu, Uh, Xu, Xu, Re^Pr\o, Uh, Xu, Xue, Cv, Cv, Wwt, Wwt, Gs^Fms, Gs^Fms, Gg, Gs^Fms, Ss, Gs^Fms, Gs^Fms, Gs^Fms, Gs^Fms, Gs
Gs^Fms, Gs^Fms, Gg, Gg, Gs^Fms, Gs^Fms, Gs, Gs^Fms, Gs, Gs^Fms, Gs^Fms, Gs, Gs^Fms, Gs^Fms, Gs, Gg, Gs^Fms, Gs, Gg, Gs^Fms, Gs^Fms, Xue, Xu, Sm, Uue, Uh, Re, Xu, Sm, Re, Uh, Xu, Uh, Re, Uue, Xu, Uh, Re, Sm, Xu, Xu, Xue, Sm, Wwg, Gg, Gg, Gs^Fms, Gg, Gs^Fms, Gs^Fms, Gs^Fms, Gg, Gs, Gs^Fms, Gs^Fms, Gs
Gs^Fms, Gs^Fms, Gs^Fms, Gs^Fms, Gs^Fms, Gg, Gg, Gs^Fms, Gs^Fms, Ss, Gs^Fms, Gs^Fms, Gs^Fms, Gs^Fms, Gs^Fms, Gs^Fms, Gs, Gs^Fms, Gg, Gg, Gs^Fms, Xue, Cer^Vu, Sm, Re, Re, Uh, Xu, Wwf, Uue, Xu, Xu, Xu, Uue, Xu, Xu, Xu, Uue, Xu, Xu, Xu, Xue, Gll, Gg, Gs^Fms, Gs, Gs, Gs, Gs^Fms, Gg, Gs^Fms, Gg, Ss, Gs^Fms, Gs^Fms, Gg
Gg, Gg, Gg, Ss, Gs^Fms, Gs^Fms, Gg, Gs^Fms, Gs^Fms, Gg, Gg, Gs^Fms, Gs^Fms, Gs^Fms, Gs, Gs, Ss, Gs^Fms, Gs^Fms, Gs^Fms, Gll, Xue, Ker, Wwf, Uue, Re, Uh, Xu, Xu, Xu, Re, Uh, Uue, Xu, Uue, Uh, Uh, Xu, Wwg, Sm, Xu, Xue, Gs^Fms, Gs^Fms, Gg, Gs, Ss, Gs^Fms, Gs^Fms, Gs, Gs^Fms, Gs, Gs^Fms, Gg, Gg, Gg
Gs^Fms, Gg, Gs^Fms, Gg, Gs^Fms, Gs^Fms, Gg, Gs^Fms, Gs^Fms, Gs, Gs^Fms, Gs^Fms, Gs^Fms, Gs^Fms, Gs^Fms, Gg, Gs^Fms, Gs^Fms, Gs^Fms, Gg, Gll, Xue, Xue, Cer, Sm, Re, Re, Uue, Sm, Re, Uh, Re, Sm, Uue, Re, Re, Wwf, Wwf, Re, Uue, Uh, Xue, Gll, Gs^Fms, Gg, Gs^Fms, Gs^Fms, Gg, Gs^Fms, Gs^Fms, Gs, Gs^Fms, Gg, Gs^Fms, Gg, Gg
Gs^Fms, Gs^Fms, Gs, Gs^Fms, Gs^Fms, Gs^Fms, Gs, Gg, Gs, Gs^Fms, Gs^Fms, Gg, Gs, Gs, Gs^Fms, Gs^Fms, Gs^Fms, Gg, Gs^Fms, Gs^Fms, Gg, Gs^Fms, Xue, Xu, Xu, Wwg, Wwf, Re, Wwf, Wwf, Wwg, Sm, Xu, Sm, Xu, Wwg, Sm, Sm, Xu, Re, Uue, Xue, Gll, Gs^Fms, Gg, Gs, Gg, Gs^Fms, Gg, Gs^Fms, Gs^Fms, Gs^Fms, Gg, Gs^Fms, Gs^Fms, Gs^Fms
Gg, Gs^Fms, Gs^Fms, Gs, Gg, Gs^Fms, Gs^Fms, Gs, Gs^Fms, Gs^Fms, Gs^Fms, Gs^Fms, Gs^Fms, Gg, Gs^Fms, Gg, Gg, Gs, Gs^Fms, Gs^Fms, Gs^Fms, Gs^Fms, Xue, Sm, Uue, Xu, Xu, Xu, Xu, Xu, Xu, Xu, Re, Xu, Sm, Xu, Wwf, Xu, Wwf, Re, Uue, Xue, Gs^Fms, Gs^Fms, Gs, Gs^Fms, Gg, Gs^Fms, Gs^Fms, Gs^Fms, Gs^Fms, Ss, Gs^Fms, Gs^Fms, Gs, Gg
Gs^Fms, Gg, Gs^Fms, Gs^Fms, Ss, Gs^Fms, Gs^Fms, Gs^Fms, Gg, Gg, Gs, Gs^Fms, Gs, Gs^Fms, Gs^Fms, Gs^Fms, Gs, Gs^Fms, Gs, Gs^Fms, Gg, Gs^Fms, Xue, Wwg, Re, Uh, Re, Uue, Re, Re, Re, Uh, Re, Uue, Sm, Cte, Kte, Sm, Re, Wwf, Xu, Xue, Gs^Fms, Gs^Fms, Gs^Fms, Gs^Fms, Gs^Fms, Gs^Fms, Gg, Gg, Gs, Gs^Fms, Gs, Gs^Fms, Gs, Gg
Gs^Fms, Gs^Fms, Gs^Fms, Gg, Gs^Fms, Gs^Fms, Gg, Gs^Fms, Gg, Gs, Ss, Gs^Fms, Gg, Gs, Gs^Fms, Gs^Fms, Ss, Gs, Gs^Fms, Gs^Fms, Gs^Fms, Gs^Fms, Xue, Wwg, Wwf^Ii, Uh, Wwf, Re, Uue, Uh, Uue, Re, Wwg, Wwf, Uh, Cte, Cte, Uh, Xu, Xu, Xue, Xue, Gs^Fms, Gg, Gs^Fms, Gs^Fms, Gs^Fms, Gs^Fms, Gs^Fms, Gs^Fms, Gs^Fms, Gs^Fms, Gg, Gs, Gs^Fms, Gg
Gg, Gs^Fms, Gs^Fms, Gs^Fms, Gs^Fms, Gg, Gs^Fms, Gs^Fms, Gs^Fms, Gs^Fms, Gs^Fms, Gs^Fms, Gs^Fms, Gs^Fms, Gs, Gs^Fms, Gg, Gs^Fms, Gs^Fms, Gg, Gg, Gll, Gll, Xue, Sm^Pr\, Wwf^Ii, Xue, Sm, Sm, Wwg, Xue, Xue, Xue, Xue, Xue, Uh, Xue, Xue, Xue, Xue, Sm, Gll, Gg, Gs^Fms, Gg, Ss, Gs^Fms, Gs^Fms, Gs^Fms, Ss, Gg, Gs^Fms, Gs^Fms, Gs^Fms, Gg, Gs^Fms
Gs, Gs^Fms, Gs^Fms, Gs^Fms, Gs^Fms, Gs^Fms, Gs, Gs^Fms, Gs^Fms, Gg, Gs^Fms, Gs^Fms, Gs^Fms, Gg, Gg, Gs^Fms, Gg, Gg, Gs^Fms, Gs^Fms, Gg, Gg^Fms, Wwg, Sm, Gll, Xue, Gll, Xue, Xue, Xue, Gll, Xue, Gll, Xue, Gll, Xue, Gll, Gll, Gll, Gll, Wwg, Gg, Gg, Gs^Fms, Gs^Fms, Gs^Fms, Gs, Gg, Gs^Fms, Gs, Gs^Fms, Gs^Fms, Gs^Fms, Gs^Fms, Gs, Gg
Gs^Fms, Gs^Fms, Ss, Gs^Fms, Gs^Fms, Gs^Fms, Gs^Fms, Gg, Gg, Gs^Fms, Gg, Gs, Gs^Fms, Gs^Fms, Gs, Gs^Fms, Gg, Gs^Fms, Gg, Gg, Wwt, Wwg, Gg, Gs, Gg, Gll^Fms, Gs^Fms, Gs^Fms, Gll, Sm, Wwg, Gll, Gs, Gs^Fms, Gs^Fms, Gs^Fms, Gs^Fms, Gs^Fms, Gs^Fms, Gs, Gs^Fms, Wwg, Gs^Fms, Gs^Fms, Gs^Fms, Gs^Fms, Gs, Gs^Fms, Gs^Fms, Gs^Fms, Gs^Fms, Gs^Fms, Ss, Gs^Fms, Gs^Fms, Gs
Gs^Fms, Gs^Fms, Gg, Gs^Fms, Gs, Gs^Fms, Gs^Fms, Ss, Gs, Gs^Fms, Gs^Fms, Gs^Fms, Gs, Gs^Fms, Gs, Gs^Fms, Gs^Fms, Ss, Gs^Fms, Gg^Fms, Wwt, Gs, Gs^Fms, Gs^Fms, Gs^Fms, Ss, Gs^Fms, Gs^Fms, Gg, Gs^Fms, Wwg, Gg, Gs^Fms, Gs^Fms, Gs^Fms, Gs, Gs, Ss, Gs^Fms, Gs, Gs^Fms, Wwt, Gg, Gg, Gs^Fms, Gs^Fms, Ss, Gs^Fms, Gg, Gs^Fms, Gs, Gs^Fms, Gs^Fms, Gg, Gs^Fms, Gg
Gs^Fms, Gs^Fms, Gs^Fms, Gg, Gs^Fms, Gs^Fms, Gg, Gs^Fms, Gs^Fms, Gs^Fms, Gs^Fms, Gs^Fms, Ss, Gs^Fms, Gs^Fms, Gs^Fms, Gs^Fms, Gg, Gs^Fms, Gg^Fms, Wwt, Gs^Fms, Gs^Fms, Gs, Gg, Gs, Gs^Fms, Gs^Fms, Gs^Fms, Gg, Gg, Wwt, Gg, Gs, Ss, Gs, Gs^Fms, Gs^Fms, Gg, Gg, Wwrt, Wwt, Gs^Fms, Gs^Fms, Gs, Gs^Fms, Gs^Fms, Gs^Fms, Gs^Fms, Ss, Gs, Gs^Fms, Gs, Gs^Fms, Gs, Gs^Fms
Gs^Fms, Gs^Fms, Gs^Fms, Gs^Fms, Ss, Gs^Fms, Gs^Fms, Gg, Gs^Fms, Gs, Gs^Fms, Gs^Fms, Gg, Gs^Fms, Gg, Gg, Gs^Fms, Gs^Fms, Gg, Gg, Wwt, Gs, Gg, Gs, Gs^Fms, Gg, Gs^Fms, Ss, Gs^Fms, Gs, Gg^Fms, Wwt, Wwrt, Gg, Gs^Fms, Gs^Fms, Gs^Fms, Gg, Gg^Fms, Wwt, Gg^Fms, Gg, Ss, Gs, Gs^Fms, Gs^Fms, Gs^Fms, Gs^Fms, Gg, Gs^Fms, Gs^Fms, Gs^Fms, Gg, Gs^Fms, Gs^Fms, Gs
Gs^Fms, Gs^Fms, Gs^Fms, Gs^Fms, Gs^Fms, Gg, Gs^Fms, Gs^Fms, Gs^Fms, Gs, Gs^Fms, Gs, Gs^Fms, Gs^Fms, Gg, Gs^Fms, Gs^Fms, Ss, Gs^Fms, Gg, Gg, Wwrt, Gs, Gs^Vct, Ce, Gs, Gs, Gs^Fms, Gs^Fms, Gs^Fms, Gs^Fms, Gg^Fms, Wwrt, Gg^Fms, Gg^Fms, Gs^Fms, Gg^Fms, Gg, Wwt, Wwt, Gg, Gg, Gs^Fms, Gs^Fms, Gs^Fms, Gg, Ss, Gs^Fms, Gs^Fms, Gs^Fms, Gs, Gg, Ss, Gs^Fms, Gs^Fms, Gg
Gs^Fms, Gs, Gs^Fms, Gs, Gs^Fms, Gs, Gs^Fms, Gg, Ss, Gs, Gs^Fms, Gs^Fms, Gs^Fms, Gs^Fms, Gs^Fms, Gg, Gs^Fms, Gg, Gs, Gs^Fms, Gs, Wwrt, Gs, Ce, Ke, Ce, Gs, Gs, Gg, Gs^Fms, Gs^Fms, Gg, Gg, Wwt, Wwt, Gg, Gg, Wwrt, Gg, Gg, Gs^Fms, Gs, Gs^Fms, Gs, Gs, Gs^Fms, Gg, Gs^Fms, Gs^Fms, Gs^Fms, Gs^Fms, Gs^Fms, Gs^Fms, Gs^Fms, Gs^Fms, Gs^Fms
Gs^Fms, Gs^Fms, Ss, Gs^Fms, Gg, Gs^Fms, Gs, Gs^Fms, Gg, Gs^Fms, Gs^Fms, Gg, Gs, Ss, Gs^Fms, Gs^Fms, Gs, Gs^Fms, Gs^Fms, Gs, Wwt, Wwt, Gs^Fms, Ce, Ce, Ce, Gs, Gs, Gs, Gs, Gg, Gg, Gg, Gg, Gg, Wwt, Wwrt, Wwt, Gg, Gs^Fms, Gg, Gs^Fms, Ss, Gs^Fms, Gs^Fms, Gs^Fms, Gg, Gs^Fms, Ss, Gs^Fms, Gs^Fms, Gs, Gs^Fms, Gs, Gs^Fms, Gs^Fms
Gs^Fms, Gg, Gg, Gs^Fms, Gs^Fms, Gs, Gs^Fms, Gs^Fms, Gs^Fms, Gg, Gs^Fms, Gs^Fms, Gg, Gs^Fms, Gg, Gs^Fms, Gg, Gs^Fms, Gs^Fms, Gg^Fms, Wwt, Gg^Fms, Gs^Fms, Gs^Fms, Gs^Fms, Gs, Gs^Fms, Gs^Fms, Gs^Fms, Gs^Fms, Gg, Gs^Fms, Ss, Gs^Fms, Gs^Fms, Gg^Fms, Gg^Fms, Wwt, Wwt, Gg, Gs^Fms, Gg, Gs^Fms, Gg, Gs^Fms, Gs^Fms, Gs^Fms, Gs^Fms, Gs^Fms, Gs, Gs^Fms, Gs, Gs^Fms, Gs, Gs^Fms, Gs^Fms
Gs^Fms, Gs^Fms, Gs^Fms, Gs^Fms, Gg, Gs^Fms, Gs^Fms, Gs^Fms, Gg, Gs^Fms, Gg, Gs^Fms, Gs^Fms, Gs^Fms, Gg, Gs^Fms, Gs^Fms, Gs, Gg^Fms, Wwt, Gg, Gs, Gs^Fms, Gs^Fms, Gs^Fms, Gs^Fms, Gg, Gs^Fms, Gg, Gs^Fms, Gs^Fms, Gs^Fms, Gs^Fms, Gs^Fms, Gs^Fms, Gs^Fms, Gg^Fms, Gg^Fms, Wwt, Gg, Gg, Gg, Gg, Gg, Gs^Fms, Gs^Fms, Gs^Fms, Gs^Fms, Gs^Fms, Gg, Gs^Fms, Gs, Gs^Fms, Gs^Fms, Gs^Fms, Gs^Fms
