Xue, Xue, Xue, Xue, Xue, Xue, Xue, Xue, Xue, Xue, Xue, Xue, Xue, Xue, Xue, Xue, Xue, Xue, Xue, Xue, Xue, Xue, Xue, Xue, Xue, Xue, Xue, Xue, Xue, Xue, Xue, Xue, Xue, Xue, Xue, Qxe, Xue, Xue, Xue, Xue, Xue, Xue
Xue, Xue, Xue, Xue, Re, Uue, Uh, Uh, Uue, Uue, Re, Uue, Uue, Uh, Re^Br/, Re^Br\, Re^Br\, Uue, Uue, Uh, Uh, Re^Edt, Re^Br/, Uh, Uue, Uue, Uue, Uh, Uh, Xue, Qxe, Xue, Xue, Xue, Qxe, Qxe, Xue, Xue, Uh, Uh, Uh, Xue
Xue, Xue, Uh, Uh, Re, Re, Re^Br\, Re, Re^Br/, Re^Br\, Re^Br\, Re^Edt, Re^Edt, Re^Br/, Xue, Uue, Uue, Re^Br\, Re^Br\, Uue, Re^Edt, Re^Edt, Re, Re^Br\, Re^Br\, Uue, Re, Uue, Re^Edt, Uue, Qxe, Qxe, Uh, Uue, Qxe, Qxe, Qxe, Uue, Uue, Uue, Re, Xue
Xue, Xue, Uue, Uue, Uue, Uue, Uue, Re^Br/, Uue, Re, Uue, Re^Br\, Re^Br\, Uue, Uh, Xue, Re^Dr, Uue, Xue, Re^Edt, Re, Re^Edt, Xue, Uue, Uue, Re^Br\, Re^Br/, Re^Edt, Re^Edt, Re^Br\, Qxe^Br\, Uh, Uue, Uue, Uh, Qxe, Qxe, Qxe, Qxe, Re^Br/, Re^Br\, Uh
Xue, Xue, Re^Dr, Re^Dr, Xue, Xue, Xue, Uh, Xue, Uue, Uh, Uh, Re, Re^Br\, Re^Edt, Uue, Uue, Xue, Uh, Xue, Xue, Xue, Xue, Xue, Xue, Uh, Uh, Re, Xue, Qxe, Re, Re^Br\, Re^Br\, Re, Re, Uh, Re^Br/, Qxe^Br/, Qxe, Re, Re^Br|, Re^Br\
Xue, Uue, Re, Re, Uue, Uue, Re, Xue, Uue, Xue, Re^Pr\, Uh, Uue, Uue, Re^Edt, Re^Edt, Re^Br/, Uh, Uue, Uh, Uue, Uue, Re^Edt, Re, Uue, Xue, Xue, Xue, Uue, Uue, Uh, Uh, Uue, Re^Br\, Re^Br/, Re^Br/, Re, Qxe, Qxe, Uh, Re^Br|, Uue
Xue, Uue, Uue, Re, Uh, Re^Ebn, Uue, Re, Re, Re, Xue, Xue, Qxe, Uue, Re^Br/, Re^Br/, Uue, Re^Br\, Re^Br\, Uue, Uue, Uh, Re^Br/, Re^Edt, Re^Edt, Uue, Re, Re, Re^Br/, Uue, Re, Uh, Re^Br/, Re^Br/, Uh, Uh, Qxe, Qxe, Qxe, Uh, Re^Br|, Uue
Xue, Uh, Uh, Re, Uh, Uh, Xue, Re, Uue, Xue, Uh, Uue, Qxe, Qxe, Xue, Uue, Uh, Uue, Uue, Re^Br\, Re^Br/, Re^Br/, Uue, Re, Uh, Re^Br\, Re^Br\, Re^Br/, Uue, Re^Br\, Re^Br\, Re^Br/, Re, Uue, Xue, Xue, Qxe, Qxe, Qxe, Re^Edt, Re^Edt, Re
Xue, Xue, Xue, Xue, Xue, Xue, Xue, Xue, Xue, Xue, Uh, Qxe, Qxe^Br\, Qxe, Uue, Xue, Xue, Uh, Xue, Re, Re, Uue, Xue, Uh, Uh, Uh, Uue, Uue, Uh, Re, Xue, Re^Br\, Re^Br\, Uue, Uue, Xue, Uh, Uh, Uh, Qxe, Qxe, Re
Xue, Xue, Uh, Uh, Uue, Uh, Uh, Re, Uue, Xue, Xue, Qxe, Qxe, Re^Br\, Re^Br\, Uue, Uue, Xue, Uh, Xue, Xue, Xue, Uue, Xue, Xue, Xue, Xue, Re, Re^Pr/, Xue, Uh, Xue, Xue, Re^Edt, Re^Edt, Uue, Uue, Uue, Re^Br/, Re^Edt, Uh, Qxe
Wog, Wwg, Uue, Re, Re, Uh, Re, Re, Re, Uh, Uue, Xue, Uh, Uh, Uue, Re^Br\, Re^Edt, Uh, Uue, Uue, Uue, Re, Uue, Uh, Xue, Uh, Uh, Xue, Re, Uue, Uue, Uue, Xue, Re^Edt, Re, Re^Br\, Re^Br\, Re^Br/, Uh, Uue, Uh, Xue
Xue, Wwg, Uh, Re, Uue, Re, Uh, Uue, Re, Uue, Uue, Xue, Xue, Uh, Uh, Uue, Re^Edt, Re^Edt, Re^Edt, Uue, Re, Re, Re^Dr, Xue, Uh, Uue, Uue, Uue, Re, Re, Re, Re, Uh, Re^Dr, Re^Dr, Uue, Uue, Re, Uue, Uue, Xue, Xue
Xue, Uh, Uue, Uh, Uue, Re, Uue, Uh, Uue, Uue, Uh, Xue, Xue, Uue, Uue, Re, Re^Br/, Re^Br/, Uh, Re, Re, Uue, Xue, Uh, Uh, Re, Re, Uue, Uh, Uh, Re, Uue, Re, Re, Uue, Xue, Uh, Uue, Uh, Uue, Xue, Xue
Gll^Fp, Xue, Xue, Xue, Xue, Re, Xue, Uh, Xue, Xue, Xue, Xue, Xue, Uue, Uh, Re^Br|, Re, Uue, Uue, Uue, Uue, Uh, Xue, Uue, Uue, Re, Re, Qxe, Qxe, Uh, Qxe, Re, Uh, Uue, Uue, Xue, Xue, Uh, Xue, Xue, Xue, Xue
Gll^Fp, Gll^Fp, Gll^Fp, Gll^Fp, Gs, Gll, Gll, Xue, Gll^Fp, Gll^Fp, Gll^Fp, Qxe, Qxe, Xue, Uh, Re^Br|, Re, Uue, Uh, Xue, Xue, Xue, Uh, Xue, Re^Pr\, Re, Xue, Re, Uue, Qxe, Re, Uue, Uue, Uh, Xue, Xue, Xoi, Xue, Xoi, Xue, Xue, Xue
Gll, Ss, Gs, Gg, Gs, Gs, Gg, Gs, Gll, Ss, Gll^Fp, Gll^Fp, Qxe, Xue, Uue, Re^Br|, Re^Br\, Re, Uh, Uh, Uue, Uue, Uue, Re, Re, Xue, Uue, Xue, Xue, Uh, Xue, Xue, Xue, Xue, Xoi^Efs, Xoi^Efs, Iwr, Xoi^Efs, Iwr, Xoi^Efs, Xoi^Efs, Xue
Gll^Fp, Gll, Gg, Gll^Fp, Gs, Gs, Ss, Gs, Gll^Fp, Gll^Fp, Gs, Gll^Fp, Qxe, Xue, Xue, Uue, Re, Re^Br\, Re^Br\, Re, Re^Br/, Re, Uue, Uue, Uh, Uh, Uue, Uue, Xue, Xue, Re, Uh, Xue, Xoi, Iwr, Iwr, Icn, Icn, Icn, Iwr, Xoi, Xue
Gll^Fp, Gll^Fp, Gs, Gs, Gs, Gg, Gs, Gll, Gll^Fp, Gll^Fp, Gll^Fp, Gll^Fp, Gll^Fp, Qxe, Xue, Uue, Uue, Uue, Re, Re^Br\, Re, Re^Br\, Re^Br\, Re, Re^Edt, Uue, Uue, Xue, Qxe, Uue, Re^Br|, Re, Xue, Xoi, Iwr, Icn, Icn, Icn, Icn, Iwr, Xoi, Xue
Gll^Fp, Gll^Fp, Gg, Gs, Gs, Gg, Gll^Fp, Gll^Fp, Gll^Fp, Gs, Gll, Gll^Fp, Gll^Fp, Qxe, Qxe, Xue, Uh, Uh, Uh, Uue, Uue, Uue, Qxe, Qxe, Re^Edt, Re, Uue, Uh, Qxe, Uue, Re^Br/, Re, Re^Dr, Xuc, Iwr, Icn, Icn, Icn, Icn, Iwr, Xoi, Xue
Gll^Fp, Gll^Fp, Gg, Gg, Ss, Gs, Gs, Gll^Fp, Gll^Fp, Gll^Fp, Gll^Fp, Gll^Fp, Gll^Fp, Gll^Fp, Qxe, Xue, Xue, Uh, Xue, Uue, Uh, Uh, Qxe, Qxe, Re, Re^Br\, Re^Br\, Uh, Re^Br/, Qxe^Br/, Uue, Uh, Xue, Re^Dr, Iwr, Icn, Icn, Icn, Iwr, Iwr, Xoi, Xue
Gll^Fp, Gll, Gg, Ss, Gs, Gg, Gs, Gg, Gg, Gs, Gs, Ss, Ss, Gll^Fp, Gll^Fp, Qxe, Gs, Xue, Gll^Fp, Xue, Xue, Xue, Xue, Xue, Xue, Uue, Uue, Re^Br\, Re, Qxe, Uh, Uh, Xue, Xuc, Xoi, Iwr, Iwr, Iwr, Xue, Xoi, Xue, Xue
Gll^Fp, Gll^Fp, Gs, Gg, Gg, Gg, Gs, Gg, Ss, Gg, Gg, Gll, Gll^Fp, Gll^Fp, Gll^Fp, Qxe, Gs, Gs, Gll^Fp, Gll^Fp, Gll^Fp, Gll^Fp, Gll^Fp, Gll^Fp, Gll^Fp, Xue, Xue, Uue, Xue, Qxe, Xue, Xue, Xue, Xue, Xue, Xoi, Xue, Gs^Pw/, Gs, Xue, Gll^Fp, Gs
Gll^Fp, Gll^Fp, Gll^Fp, Gll, Gll^Fp, Gs, Gg, Gs, Ss, Ss, Gs, Gg, Gll^Fp, Gs, Gll^Fp, Qxe, Qxe, Gs, Gs, Gs, Gll^Fp, Gll^Fp, Gll^Fp, Gll^Fp, Gll^Fp, Gll^Fp, Gll^Fp, Xue, Gll^Fp, Xue, Gll^Fp, Xue, Gll^Fp, Gll^Fp, Gll^Fp, Xue, Gll^Fp, Gs, Gs, Gs, Gll^Fp, Gs
Gll^Fp, Gll^Fp, Gll^Fp, Gs, Gll^Fp, Gs, Gll^Fp, Ss, Gg, Gg, Gs, Gs, Gs, Gll^Fp, Gll^Fp, Gll^Fp, Qxe, Gs, Gs, Gs, Gs, Gll^Fp, Gll^Fp, Gll^Fp, Gll^Fp, Gll^Fp, Gll^Fp, Gs, Gll^Fp, Gll^Fp, Gll^Fp, Gll^Fp, Gll^Fp, Gll^Fp, Gll^Fp, Gll^Fp, Gll^Fp, Gs, Gs, Gs, Gs, Gs
Gll^Fp, Ss, Ss, Gll^Fp, Gs, Gll^Fp, Gll^Fp, Gll^Fp, Gll^Fp, Gg, Gg, Gs, Ss, Gll, Gll^Fp, Gll^Fp, Qxe, Gll^Fp, Gll^Fp, Gll^Fp, Gll^Fp, Gll^Fp, Gs, Gs, Gs, Gll^Fp, Gll^Fp, Gs, Gs, Gs, Gs, Gs, Gs, Gll^Fp, Gll^Fp, Gll^Fp, Gs, Gll^Fp, Gs, Gs, Gll^Fp, Gs
Gll^Fp, Ss, Gll^Fp, Gll^Fp, Gll^Fp, Gll^Fp, Gll, Gll^Fp, Gg, Gs, Gs, Gs, Gs, Gs, Gll^Fp, Gll^Fp, Qxe, Gs, Gll^Fp, Gll^Fp, Gs, Gs, Gll^Fp, Gs, Gll^Fp, Gll^Fp, Gll^Fp, Gs, Gll^Fp, Gs, Gll^Fp, Gs, Gll^Fp, Gs, Gs, Gs, Gs, Gs, Gll^Fp, Gll^Fp, Gll^Fp, Gs
Gll^Fp, Gll^Fp, Gll^Fp, Gll^Fp, Gs, Gs, Gs, Gs, Gs, Gs, Gg, Gg, Gs, Gll^Fp, Gll^Fp, Gll^Fp, Qxe, Gll^Fp, Gll^Fp, Gs, Gs, Gs, Gll^Fp, Gll^Fp, Gs, Gs, Gll^Fp, Gll^Fp, Gll^Fp, Gll^Fp, Gll^Fp, Gll^Fp, Gll^Fp, Gll^Fp, Gs, Gll^Fp, Gll^Fp, Gll^Fp, Gll^Fp, Gll^Fp, Gll^Fp, Gs
Gll^Fp, Gll, Gll^Fp, Gll, Gg, Gs, Gg, Gg, Gs, Ss, Gg, Gs, Gll^Fp, Gll^Fp, Gll^Fp, Qxe, Gll^Fp, Gll^Fp, Gll^Fp, Gs, Gll^Fp, Gs, Gll^Fp, Gll^Fp, Gs, Gll^Fp, Gll^Fp, Gs, Gll^Fp, Gs, Gs, Gll^Fp, Gll^Fp, Gs, Gll^Fp, Gll^Fp, Gs, Gll^Fp, Gs, Gs, Gll^Fp, Gs
Gll^Fp, Gll^Fp, Gll^Fp, Gs, Gs, Ss, Gg, Gg, Gs, Ss, Gg, Gll^Fp, Ss, Gll^Fp, Qxe, Qxe, Gll^Fp, Gll^Fp, Gll^Fp, Gll^Fp, Gll^Fp, Gs, Gs, Gll^Fp, Gll^Fp, Gs, Gll^Fp, Gll^Fp, Gll^Fp, Gll^Fp, Gs, Gs, Gs, Gs, Gll^Fp, Gll^Fp, Gll^Fp, Gs, Gs, Gs, Gll^Fp, Gs
Gll^Fp, Gll^Fp, Gll, Gs, Gg, Gs, Gs, Gs, Gll^Fp, Gs, Gll^Fp, Gll^Fp, Gll^Fp, Gll^Fp, Qxe, Gs, Gll^Fp, Gll^Fp, Gs, Gs, Gll^Fp, Gs, Gll^Fp, Gs, Gll^Fp, Gll^Fp, Gll^Fp, Gs, Gs, Gll^Fp, Gs, Gll^Fp, Gs, Gll^Fp, Gll^Fp, Gll^Fp, Gll^Fp, Gll^Fp, Gll^Fp, Gll^Fp, Gs, Gs
Gll^Fp, Gll^Fp, Gll^Fp, Gg, Gg, Gg, Ss, Gg, Gll^Fp, Gll^Fp, Gll^Fp, Gs, Gll^Fp, Gll^Fp, Qxe, Gs, Gll^Fp, Gs, Gs, Gs, Gs, Gll^Fp, Gs, Gll^Fp, Gll^Fp, Gll^Fp, Gs, Gll^Fp, Gll^Fp, Gs, Gll^Fp, Gll^Fp, Gll^Fp, Gll^Fp, Gll^Fp, Gs, Gll^Fp, Gll^Fp, Gs, Gs, Gs, Gs
Gll^Fp, Gll^Fp, Gg, Gg, Ss, Ss, Gg, Ss, Gs, Gll^Fp, Gll^Fp, Gll, Gll^Fp, Qxe, Gll^Fp, Gll^Fp, Gll^Fp, Gll^Fp, Gll^Fp, Gll^Fp, Gll^Fp, Gs, Gll^Fp, Gs, Gll^Fp, Gll^Fp, Gll^Fp, Gll^Fp, Gll^Fp, Gs, Gs, Gll^Fp, Gs, Gll^Fp, Gll^Fp, Gs, Gs, Gll^Fp, Gll^Fp, Gs, Gll^Fp, Gs
Gll^Fp, Gll^Fp, Gs, Gs, Gs, Ss, Gg, Gg, Gs, Gll^Fp, Gll^Fp, Gll^Fp, Gll^Fp, Qxe, Gll^Fp, Gll^Fp, Gll^Fp, Gs, Gs, Gll^Fp, Gll^Fp, Gll^Fp, Gs, Gll^Fp, Gll^Fp, Gs, Gll^Fp, Gll^Fp, Gll^Fp, Gs, Gs, Gs, Gll^Fp, Gll^Fp, Gs, Gll^Fp, Gll^Fp, Gs, Gll^Fp, Gll^Fp, Gll^Fp, Gs
Gll^Fp, Ss, Gll^Fp, Gs, Gg, Gs, Gs, Gs, Gg, Gs, Gll^Fp, Ss, Gll^Fp, Qxe, Qxe, Gll^Fp, Gll^Fp, Gs, Gs, Gs, Gll^Fp, Gll^Fp, Gs, Gll^Fp, Gs, Gll^Fp, Gll^Fp, Gll^Fp, Gs, Gll^Fp, Gll^Fp, Gll^Fp, Gll^Fp, Gs, Gs, Gll^Fp, Gll^Fp, Gll^Fp, Gll^Fp, Gll^Fp, Gll^Fp, Gs
Gll^Fp, Gll^Fp, Gll^Fp, Gll^Fp, Gll^Fp, Gg, Gs, Gs, Ss, Gg, Gll^Fp, Gll^Fp, Gll, Gll^Fp, Qxe, Gs, Gll^Fp, Gll^Fp, Gll^Fp, Gll^Fp, Gs, Gll^Fp, Gll^Fp, Gll^Fp, Gs, Gll^Fp, Gll^Fp, Gll^Fp, Gs, Gll^Fp, Gll^Fp, Gll^Fp, Gs, Gll^Fp, Gll^Fp, Gs, Gll^Fp, Gll^Fp, Gll^Fp, Gll^Fp, Gs, Gs
Gll^Fp, Gll^Fp, Gs, Gll^Fp, Gll, Gg, Gs, Gs, Gg, Gll, Gll^Fp, Gs, Gll^Fp, Gll^Fp, Qxe, Gs, Gll^Fp, Gs, Gll^Fp, Gll^Fp, Gs, Gll^Fp, Gll^Fp, Gll^Fp, Gs, Gll^Fp, Gs, Gll^Fp, Gll^Fp, Gll^Fp, Gs, Gll^Fp, Gll^Fp, Gll^Fp, Gll^Fp, Gs, Gll^Fp, Gs, Gs, Gll^Fp, Gll^Fp, Gs
Gll^Fp, Gll^Fp, Ss, Ss, Gg, Gs, Gs, Gg, Gs, Ss, Gll^Fp, Gll^Fp, Gll^Fp, Gll^Fp, Gll^Fp, Qxe, Gll^Fp, Gll^Fp, Gll^Fp, Gll^Fp, Gll^Fp, Gs, Gs, Gs, Gll^Fp, Gs, Gs, Gll^Fp, Gs, Gs, Gs, Gs, Gll^Fp, Gll^Fp, Gs, Gs, Gll^Fp, Gs, Gll^Fp, Gs, Gs, Gs
Gll^Fp, Gll^Fp, Gll^Fp, Gll^Fp, Gg, Gs, Gs, Gg, Gg, Gll^Fp, Gll^Fp, Gll^Fp, Gll^Fp, Gll^Fp, Gll^Fp, Qxe, Gll^Fp, Gs, Gs, Gs, Gll^Fp, Gll^Fp, Gll^Fp, Gll^Fp, Gll^Fp, Gll^Fp, Gll^Fp, Gll^Fp, Gll^Fp, Gll^Fp, Gs, Gll^Fp, Gll^Fp, Gs, Gll^Fp, Gll^Fp, Gll^Fp, Gll^Fp, Gll^Fp, Gs, Gs, Gs
Gll^Fp, Gll^Fp, Gll^Fp, Gll^Fp, Gll^Fp, Gll^Fp, Cv, Gs, Gg, Gll^Fp, Gll^Fp, Gs, Ss, Gll^Fp, Gll^Fp, Qxe, Gs, Gll^Fp, Gll^Fp, Gll^Fp, Gs, Gll^Fp, Gll^Fp, Gll^Fp, Gs, Gll^Fp, Gs, Gs, Gs, Gll^Fp, Gll^Fp, Gs, Gs, Gll^Fp, Gll^Fp, Gll^Fp, Gll^Fp, Gs, Gs, Gll^Fp, Gs, Gs
Gll^Fp, Gll^Fp, Gs, Gll^Fp, Gg, Cv, Kv, Cv, Gll^Fp, Gll^Fp, Gll^Fp, Gll^Fp, Gll^Fp, Gll^Fp, Qxe, Qxe, Gs, Gll^Fp, Gll^Fp, Gll^Fp, Gs, Gll^Fp, Gll^Fp, Gs, Gll^Fp, Gll^Fp, Gll^Fp, Gs, Gs, Gll^Fp, Gll^Fp, Gs, Gll^Fp, Gll^Fp, Gll^Fp, Gll^Fp, Gll^Fp, Gs, Gll^Fp, Gs, Gll^Fp, Gs
Gll^Fp, Gll^Fp, Gll^Fp, Gs, Gg, Cv, Cv, Cv, Gg, Gs, Gll^Fp, Gll^Fp, Gll^Fp, Gll^Fp, Qxe, Gs, Gll^Fp, Gll^Fp, Gll^Fp, Gll^Fp, Gll^Fp, Gll^Fp, Gll^Fp, Gll^Fp, Gll^Fp, Gll^Fp, Gll^Fp, Gs, Gs, Gll^Fp, Gll^Fp, Gs, Gs, Gll^Fp, Gll^Fp, Gll^Fp, Gs, Gs, Gll^Fp, Gll^Fp, Gll^Fp, Gs
Gll^Fp, Gll^Fp, Gll^Fp, Gll^Fp, Gll^Fp, Gg, Gs, Gg, Gg, Gll^Fp, Gll^Fp, Gll^Fp, Gll^Fp, Gll^Fp, Qxe, Gs, Gs, Gs, Gs, Gs, Gs, Gs, Gs, Gs, Gs, Gs, Gs, Gs, Gs, Gs, Gs, Gs, Gs, Gs, Gs, Gs, Gs, Gs, Gs, Gs, Gs, Gs
