Gs, Gs, Gg^Fms, Gg, Gg, Gs^Fms, Gs^Fms, Gs, Gs^Fms, Gs^Fms, Gs^Fms, Gg, Gg, Gg, Wwrt, Gg, Wwt, Wwt, Gg, Gg, Gg, Gg, Gs^Fms, Gg, Gg, Gg, Gg, Wwt, Wwrt, Wwrt, Wwrt, Gs^Fms, Gs^Fms, Gs^Fms, Gs^Fms, Gs, Gs^Fms, Gs^Fms, Ss, Gs^Fms
Wwt, Wwt, Wwt, Wwrt, Wwt, Gg^Fms, Gg, Gs^Fms, Ss, Gs, Gg^Fms, Gs^Fms, Wwt, Wwrt, Gg, Wwt, Gg^Fms, Gg, Gg, Gs^Fms, Gs^Fms, Gs, Gs^Fms, Ss, Gs, Gs^Fms, Gs, Gg, Gg, Gg^Fms, Wwt, Gg^Fms, Gg^Fms, Gs, Gs^Fms, Gs^Fms, Gs^Fms, Gs^Fms, Gs^Fms, Gg
Gs, Gg^Fms, Gs^Fms, Gg, Gg, Wwt, Gg, Gs^Fms, Gs, Gg, Wwt, Wwt, Gg^Fms, Gg, Gg, Gs, Ss, Gs^Fms, Gs^Fms, Gs, Gs^Fms, Gs^Fms, Gs^Fms, Gs^Fms, Gs^Fms, Gs, Gs^Fms, Ss, Gs^Fms, Gs^Fms, Gg, Wwt, Wwt, Gg^Fms, Gs, Ss, Gs^Fms, Gs, Gs^Fms, Gs^Fms
Ss, Gs^Fms, Gs^Fms, Gg, Gs, Wwrt, Wwt, Gg^Fms, Gg^Fms, Gg, Wwt, Gg, Ss, Gs^Fms, Gg, Gs^Fms, Gg, Gs^Fms, Gs^Fms, Gs, Gs, Ss, Gs, Gs, Gs^Fms, Gs^Fms, Gs^Fms, Gs, Gg, Gs^Fms, Ss, Gg, Wwrt, Gg^Fms, Gg, Gs^Fms, Gg, Gs^Fms, Gs^Fms, Gg
Gs^Fms, Gs^Fms, Gs^Fms, Ss, Gs, Gs, Gg, Wwt, Wwrt, Wwrt, Wwt, Gg, Gg, Gg, Wwt, Gg, Gg, Gg, Gg^Fms, Gs, Gg, Gs^Fms, Gs^Fms, Gs, Gs, Ss, Gs, Gs^Fms, Gg, Gs^Fms, Gg^Fms, Gg, Gg, Wwrt, Gg, Gg, Gg, Ss, Gs^Fms, Gs
Gg, Gs, Gs, Gg, Gs, Gs, Gs, Gg, Gg, Gg^Fms, Gg^Fms, Wwt, Wwt, Wwt, Cvr, Wwt, Wwt, Wwt, Wwt, Gg, Wwt, Gg, Gg, Gg, Gg^Fms, Gg, Gg, Gg, Wwrt, Wwt, Wwt, Wwrt, Wwt, Wwt, Wwt, Wwt, Wwrt, Gs^Fms, Gg, Gg
Wwrt, Gs, Gs, Gs^Fms, Gs^Fms, Ss, Gs^Fms, Gs, Gg, Gg^Fms, Wwt, Wwt, Cvr, Cvr, Gg, Cv, Cv, Cv, Cv, Wwt, Cvr, Wwt, Wwt, Wwt, Wwt, Wwt, Wwt, Wwt, Gg, Gg^Fms, Gs^Fms, Gg, Gs^Fms, Gg, Gg, Gg, Gg, Wwrt, Wwt, Gg
Wwt, Gs^Fms, Ss, Gs, Gg^Fms, Gs, Gs, Gs, Wwt, Wwt, Cv, Cv, Gg, Gs, Gs, Gg, Gs, Gs, Gg, Cv, Gg, Cvr, Cvr, Cv, Cv, Cv, Cv, Wwt, Wwt, Gg, Gg, Ss, Gs^Fms, Gs^Fms, Gs^Fms, Gs^Fms, Gg, Gg, Gs^Fms, Wwt
Wwt, Gs^Fms, Gs^Fms, Gs^Fms, Gs^Fms, Gs, Gg, Wwt, Cvr, Cvr, Gs, Gg, Gd, Gd, Gd, Gs^Edb, Gs^Edb, Gg, Gd, Gs, Gg^Fms, Gg, Gg, Gs, Gg, Gs, Gg, Cv, Cvr, Wwt, Wwt, Gg, Gs^Fms, Gs^Fms, Gg, Ss, Gs^Fms, Gs^Fms, Gs^Fms, Gg
Wwrt, Gg, Wwt, Gg, Gg, Gs^Fms, Gg, Wwt, Cv, Gd, Gll^Fdw, Gd, Gll^Fdw, Gll^Fdw, Gd, Gs^Edb, Gd, Re, Re, Gd, Gs, Gs^Fms, Gs, Gs, Gs, Gs, Gd, Gg, Gs, Cvr, Cvr, Wwt, Wwt, Gg, Gg, Gs^Fms, Gg, Gs^Fms, Gg, Gs^Fms
Gg, Wwrt, Gg, Wwt, Wwt, Gg, Wwt, Wwt, Cv, Gd, Gd, Gd, Gd, Gd, Gd^Edb, Gs, Gs, Gs, Gs, Gd, Gs^Edb, Gs^Edb, Gs, Gg^Fms, Gd, Gs^Ve, Gd, Gs, Gd, Gs, Gg, Cv, Cv, Wwt, Gs^Fms, Gs^Fms, Gs^Fms, Gs^Fms, Gs, Gs^Fms
Gg, Gg, Gg, Gg^Fms, Gg^Fms, Wwrt, Gg, Wwt, Cvr, Gs, Gs, Gd, Gs^Edb, Gd^Edb, Cvr, Cv, Cv, Gs^Fms, Gs, Gg^Fms, Wwt, Gs^Edb, Gs, Gs^Fms, Gg^Edb, Gs, Gs, Gs^Fms, Gs^Fms, Gd, Gs^Fms, Gg, Cv, Wwt, Gg^Fms, Ss, Gs^Fms, Gs^Fms, Gg, Gg
Gg, Gs^Fms, Gs^Fms, Gg, Gg, Gg, Gg, Wwt, Cvr, Gg, Gs, Gd^Ve, Gs, Gg^Edb, Cv, Kvr, Cvr, Gd, Gs, Wwt^Bw\, Gd^Ecf, Wwt, Wwt^Ewf, Gg, Gd^Edb, Gg^Edb, Gs, Gs^Fms, Gs, Gs, Gg, Gs, Cv, Wwt, Gg, Gs, Gs^Fms, Gs, Gs^Fms, Gg
Gg, Gg, Gg, Gs^Fms, Gs^Fms, Gg^Fms, Gg^Fms, Wwt, Cvr, Gg, Gd, Gs, Gd, Gs, Gs, Cvr, Gd, Gd, Re^Fdw, Wwt, Wwt^Ewf, Gs^Ve, Wwt^Bw\, Gs, Cv, Cv, Cv, Gs, Gs, Gs^Ve, Gs, Gg, Cvr, Wwt, Gg, Gs, Gs, Gs^Fms, Gs^Fms, Gs
Gg, Gg, Ss, Gs^Fms, Gg, Gg^Fms, Gg, Wwt, Cv, Gg, Gg, Gg^Fms, Gs^Fms, Gd, Gg^Edb, Gs, Gd, Re^Fdw, Re^Fdw, Gd, Gs, Wwt, Gd, Gs, Cvr, Kv, Cvr, Gd^Edb, Gs^Edb, Gs^Fms, Gd, Gd, Cvr, Wwt, Gg^Fms, Gg, Gs, Ss, Gs^Fms, Gs^Fms
Gs^Fms, Gg, Gs^Fms, Gs^Fms, Gs^Fms, Gg, Gg^Fms, Wwt, Cv, Gs, Gs^Edb, Gs^Fms, Gs^Fms, Gs, Gs^Edb, Gs^Edb, Gs, Re, Re, Gd, Gs, Gs^Fms, Gg^Fms, Gd, Gd, Cvr, Gs, Gd^Edb, Gd^Edb, Gs, Gd, Gs, Cv, Wwt, Gg, Gs^Fms, Gs^Fms, Gs^Fms, Gs, Gg
Gs^Fms, Gs^Fms, Gs^Fms, Gg, Gg, Gg, Sm, Wwg, Cv, Gs, Gs^Edb, Gs^Edb, Gs, Gs, Gs, Gs, Gs, Gd, Gd, Gd, Gs, Gg^Fms, Gs, Gs, Gs, Gd, Gs, Re^Edb, Re, Re, Gs, Gs, Cv, Wwt, Gg, Gs^Fms, Gs^Fms, Gs^Fms, Gs^Fms, Gg
Gs, Gs^Fms, Gs^Fms, Gg, Gll, Sm, Xue, Xue, Xue, Gs, Xue, Gs, Xue, Xue, Xue, Xue, Xue, Xue, Xue, Xue, Xue, Gs, Xue, Gs, Gs, Gd, Gll^Fdw, Re^Fdw, Re^Fdw, Gd, Gg, Gg, Cvr, Wwt, Gg, Gs, Ss, Gs^Fms, Gs^Fms, Gg
Gs^Fms, Gs^Fms, Gg, Gs^Fms, Gs^Fms, Xue, Sm, Xu, Uue, Xue, Sm, Xue, Wwg, Sm, Wwf, Sm, Wwf, Sm, Wwf, Wwg, Uh, Xue, Uue^Ii, Re^Pr\, Xue, Gs, Gs, Gd, Gs, Gg, Cv, Cvr, Wwt, Wwt, Gs^Fms, Gs, Gs^Fms, Gg, Gs^Fms, Gs^Fms
Gs^Fms, Gs, Gg, Gg, Gll, Xue, Wwf, Re, Re^Pr/, Xu, Re, Re, Uue, Re, Re, Re, Uh, Uue, Re, Re, Re, Re, Re, Re^Ii, Uh, Xue, Gs, Gs, Cv, Cv, Wwt, Wwt, Gg, Gg, Gg, Gs^Fms, Gs^Fms, Gg, Gg, Gg
Gs^Fms, Gs, Gs^Fms, Gg, Gs^Fms, Xue, Xu, Xu, Uue, Re, Re, Uh, Xu, Re^Pr|, Xu, Uh, Xu, Re^Pr|, Xu, Uh, Xu, Xu, Re^Pr\, Uh, Xu, Xue, Cvr, Cvr, Wwt, Wwt, Gs^Fms, Gs^Fms, Gg, Gs^Fms, Ss, Gs^Fms, Gs^Fms, Gs^Fms, Gs^Fms, Gs
Gs^Fms, Gs, Gg, Gs^Fms, Gs^Fms, Xue, Xu, Sm, Uue, Uh, Re, Xu, Sm, Re, Uh, Xu, Uh, Re, Uue, Xu, Uh, Re, Sm, Xu, Xu, Xue, Sm, Wwg, Gg, Gg, Gs^Fms, Gg, Gs^Fms, Gs^Fms, Gs^Fms, Gg, Gs, Gs^Fms, Gs^Fms, Gs
Gs, Gs^Fms, Gg, Gg, Gs^Fms, Xue, Re, Sm, Re, Re, Uh, Xu, Wwf, Uue, Xu, Xu, Xu, Uue, Xu, Xu, Xu, Uue, Xu, Xu, Xu, Xue, Gll, Gg, Gs^Fms, Gs, Gs, Gs, Gs^Fms, Gg, Gs^Fms, Gg, Ss, Gs^Fms, Gs^Fms, Gg
