Hh, Hh, Hh, Gs, Gs, Gs, Gg, Gg, Gs, Gs, Gs, Gd, Gd, Gs, Gs, Gg, Gg, Gs, Gd, Gd, Gs^Fdf, Gs^Fmf, Gd, Gd, Gs^Fdf, Hh, Hh, Hh, Hh, Hh, Hh, Hh, Hh, Hh, Hh, Hh, Gs, Gs, Hh^Fmf, Hh, Hh, Hh, Hh, Mm, Mm, Mm
Hh, Hh, Gd, Gs, Gs, Gs, Gs, Gg, Hh, Gs, Gs, Gd, Gs^Fdf, Gs^Fdf, Gs, Gg, Gs, Gs, Gs^Fdf, Gd, Gs, Gs^Fdf, Gs, Gd, Gs^Fmf, Gs^Fdf, Hh, Hh, Hh, Gd, Gs^Fdf, Hh, Mm, Mm, Hh, Gd, Gs^Fdf, Hh, Hh, Gs^Fdf, Gd, Hh, Hh^Fdf, Mm, Mm, Mm
Hh, Hh, Gll^Fmf, Gll^Fmf, Gs, Hh, Gs, Gs, Gs, Gd, Gs, Gs, Gs^Fmf, Gs^Fmf, Gs, Gs, Gs^Fmf, Gs^Fmf, Gs^Fdf, Gs, Gs, Gs, Gg, Gs, Hh, Hh^Fmf, Gg, Gs, Hh^Fmf, Gs, Gs^Fmf, Hh, Mm, Mm, Hh, Gs^Fdf, Hh^Fmf, Hh, Mm, Hh, Hh, Gs^Fdf, Hh^Fdf, Hh^Fdf, Hh^Fmf, Mm
Gs, Gs, Gs, Gs, Gs, Gs, Gs, Gs, Gs, Gs^Fmf, Gs, Hh, Hh, Gs, Gs, Hh, Gd, Gs^Fdf, Gs^Fmf, Hh, Gs, Gs, Gs^Fmf, Gs, Gs, Hh, Mm, Mm, Mm, Hh, Hh, Hh, Gll^Fmf, Mm, Hh, Hh^Fmf, Mm, Mm, Mm, Mm, Hh^Fmf, Gs^Fmf, Hh^Fmf, Gs^Fmf, Hh^Fmf, Hh
Gs, Gs, Gs, Hh, Hh, Gd, Gs^Fmf, Gs, Gs^Vh, Gs, Gd^Gvs, Gs, Gs, Gs, Gs, Hh, Gs, Gs, Gg, Gs, Hh, Gd, Gs^Fmf, Gs^Fdf, Gd, Hh, Hh^Vhh, Mm, Mm, Mm, Gs, Hh, Hh, Gd, Gs, Hh, Hh, Mm, Mm, Hh, Hh, Hh^Ve, Hh^Fdf, Hh^Fmf, Mm, Hh
Gd, Gd, Gs, Hh, Gs, Gs, Gs, Gs, Gd^Gvs, Gd^Gvs, Gd^Gvs, Gd^Gvs, Gs, Gs, Gs^Fdf, Gs, Gd, Gs, Hh, Gg, Hh^Fmf, Gs, Hh, Hh, Hh, Hh, Hh, Mm, Mm, Mm, Gs, Gs, Gs, Gd, Gs, Hh^Fmf, Hh^Fdf, Mm, Mm, Hh, Gd, Gd, Gll^Fmf, Mm, Mm, Mm
Gd, Gll^Fmf, Gg, Gs, Gg, Gs, Gs, Gs, Gs, Gd^Gvs, Gs, Hh, Gs, Gs^Fmf, Hh^Fmf, Gs^Fdf, Gd, Hh, Gd, Gs^Fdf, Gs^Fmf, Gs, Hh, Hh, Hh^Fmf, Hh, Gs, Mm, Hh, Hh, Gd, Hh, Hh, Hh, Hh, Gd, Hh, Hh, Hh, Hh, Gs, Hh, Mm, Mm, Mm, Mm
Gs, Gs, Gs, Gg, Gs, Gs, Gs, Hh, Gs, Gs^Fmf, Gs^Fmf, Gs, Gs, Hh, Gs^Fmf, Gs^Fmf, Gs, Gs, Hh^Fmf, Gs^Fmf, Hh, Hh^Fmf, Hh, Gs, Gs, Gs, Hh, Hh, Hh, Hh, Hh^Fmf, Hh, Mm, Hh, Hh, Hh, Gd, Hh, Hh, Gd, Hh^Fmf, Hh, Hh, Mm, Mm, Mm
Gs, Gs, Gs, Gs, Ce, Ce, Ce, Gs, Gs, Gs, Gg, Gs, Gs, Gs, Gs, Gs, Gs, Gs, Gs, Hh, Mm, Mm, Mm, Hh, Hh, Hh, Hh^Fdf, Hh^Fmf, Gs, Gd^Fmf, Gd^Fmf, Mm, Mm, Mm, Mm, Hh, Gs, Gd, Hh^Fmf, Hh, Hh, Gd, Gs, Hh, Gg, Hh
Hh, Hh, Gg, Gs, Ce, Ke, Ce, Gs, Gs, Gg, Gs, Hh, Gs, Gs, Gs, Hh, Hh^Fmf, Gs, Gs, Hh, Mm, Mm, Mm, Mm, Hh, Gs, Gs, Hh, Hh, Gs, Gs, Mm, Mm, Mm, Mm, Mm, Hh, Gs, Hh, Mm, Mm, Hh, Hh, Gs, Hh, Hh
Gs, Hh, Gg, Gs, Gs, Ce, Gs, Gs, Gs, Gll^Fmf, Gd, Hh, Gs, Gg, Gs, Gs^Fmf, Gs, Gs, Hh^Fmf, Hh, Hh, Mm, Hh, Hh, Gs^Fmf, Hh, Gs, Mm, Mm, Hh, Hh, Hh, Hh, Mm, Gg, Mm, Hh, Gs, Hh, Mm, Mm, Mm, Mm, Hh, Gs, Hh
Gs, Gg, Gg, Hh, Gs, Gs, Gs, Gs, Gs, Gs, Gs, Gs^Fmf, Gs, Gg, Gs, Gs, Hh, Gs, Gs, Gd, Hh, Hh, Gs, Gs, Gs, Hh, Gd, Gd, Hhd, Hh, Hh^Fmf, Gs, Gd, Gs, Hh, Gs, Hh, Hh^Vhh, Mm, Mm, Mm, Mm, Mm, Gs, Gg, Hh
Gs, Gs, Gs, Gs, Gs, Gs^Fmf, Gs^Fmf, Gs, Gs, Hh, Gs, Gs, Gd, Hh, Gs, Gs, Hh, Gs, Gs, Gs, Gs, Hh, Hh, Hh, Hh^Fmf, Hh, Sm, Sm, Ss, Gd, Hhd, Gd^Fmf, Hh, Hh, Mm, Hh, Gs, Gs, Hh, Mm, Hh, Mm, Mm, Gs, Hh, Hh
Gs, Hh, Hh, Gs, Gd, Gs^Fmf, Gs^Fmf, Gs, Gs, Hh, Hh, Gs, Gd, Gd, Gs, Hh, Gs, Gs, Gd^Fms, Gg, Hh, Gs, Hh, Hh^Fmf, Mm, Mm, Gd, Ss^Vhs, Ss, Sm, Gd, Hh, Mm, Mm, Mm, Mm, Gs^Fmf, Gd^Fmf, Gd, Hh, Hh, Hh, Hh, Hh, Gs, Hh
Gs, Gs, Hh, Gs, Gg, Gd, Gs, Gs, Gs, Gs, Gs, Gs, Gs, Gs, Gs, Gs, Hh, Gd, Hh, Hh^Fms, Hh, Hh, Hh, Mm, Mm, Mm, Hh, Gs, Sm, Sm, Hh, Mm, Mm, Mm, Mm, Mm, Gs, Hh, Hh, Hh, Gs, Gs, Hh, Hh, Gg, Hh
Gs, Gs, Gs, Gs, Hh, Gg, Gs, Gs, Hh, Gs, Gs^Fms, Gg^Fms, Gs, Hh, Hh, Hh, Mm, Hh, Mm, Hh, Hh, Gg, Gs, Mm, Mm, Hh^Fds, Gg, Gs, Gd, Hhd, Hh, Mm, Mm, Mm, Hh, Gs, Hh, Mm, Mm, Hh, Gs, Gs, Mm^Vhh, Mm, Mm, Hh
Gs, Gs, Gs, Gs, Gs, Gs, Hh, Hh, Gs, Gs, Gs, Gs, Gd, Gs, Gs, Hh, Mm, Mm, Mm, Mm, Hh^Fds, Gg^Fds, Gg, Mm, Hh, Hh, Gs, Gs, Hh, Gs, Gs, Mm, Hh, Mm, Gs, Hh, Hh, Mm, Gs, Hh, Hh, Hh, Hh, Mm, Mm, Hh
Gs^Fms, Gs^Fms, Gg^Fms, Gg, Gs, Gs, Gs, Gs, Gs, Gs, Hh, Gs, Gs, Gd, Gs, Hh, Hh, Mm, Hh, Hh, Hh, Hh^Fds, Hh, Hh, Gs, Hh, Re, Hh, Hh, Hh, Hh^Fds, Hh, Hh, Gd, Hh, Gs, Hh, Gd, Cud, Cud, Cud, Hh, Hh, Hh^Fds, Hh, Hh
Gs^Fms, Gs^Fms, Gs, Gs, Hh, Gs, Gd, Gd, Gs, Gs, Gs, Gs, Hh, Gs, Gs, Gs, Hh, Hh, Gd, Gs, Hh, Gs, Gd, Gs, Hh, Hhd, Qlf, Mm, Hhd^Fdw, Mm, Mm, Hh, Hh, Hh^Vhh, Mm, Hh, Hh, Gd, Cud, Kud, Cud, Gs, Gg, Hh, Mm, Mm
Gs, Gg, Hh, Gs, Hh, Gs, Gg, Gs, Hh, Gll, Gs^Fp, Hh, Gs, Gs, Hh, Gs, Hh, Gs, Hh, Mm, Mm, Hh, Gd, Hh, Hh, Mm, Mm, Mm, Qlf, Qlf, Re, Gd, Hh, Mm, Mm, Gs, Gs, Hh, Gs, Cud, Hh, Gs, Gg, Mm, Mm, Mm
Gs, Gs, Gs, Gs, Gs, Hh, Gs, Gg, Gs, Hh^Fp, Gll^Fp, Gll, Gs, Gll, Hh^Fp, Gs, Hh, Hh, Mm, Mm, Mm, Hh, Hh, Gs, Gs, Mm, Mm^Vd, Mv, Mm, Mm, Hh, Gs, Hh, Mm, Mm, Mm, Hh, Hh, Hh^Fds, Gs, Hh, Hh, Mm, Hh, Hh^Fds, Hh^Fds
Gs, Gll^Fp, Gll, Gs, Gs, Gs, Gll, Gs, Gs, Hh, Gs, Gs, Gs, Hh, Gs, Hh, Gs, Hh, Gs, Hh, Hh, Hh^Fds, Hh^Fds, Hh, Hh, Hh, Hhd, Mm, Qlf, Hhd, Mm, Hh, Gs, Hh, Gs, Hh, Gg, Gs, Hh, Gg, Gs, Mm, Hh, Hh, Mm, Mm^Fds
Gs, Gs, Gs, Hh, Hh^Vl, Hh, Hh^Fp, Gs, Gll^Fp, Gs, Gs, Hh, Gs, Hh, Hh^Fms, Gs, Hh, Hh^Fms, Hh, Gg, Mm, Hh^Fds, Mm, Gg, Gs, Gs, Hh, Re, Hhd, Qlf, Mm, Mm, Mm, Gs, Gg, Hh, Hh^Fds, Hh, Mm, Hh, Mm, Hh, Hh, Hh, Mm, Mm
Gs^Fp, Hh, Gll^Fp, Gs, Hh, Hh^Fp, Gll, Gs, Gs^Fp, Hh^Fp, Gs, Gs, Hh, Hh, Hh^Fms, Mm, Mm, Mm, Mm, Mm, Mm, Mm, Hh, Mm, Hh^Fds, Hh, Hh, Gd, Hh, Mm, Mm, Mm, Mm, Hh, Hh, Gg, Hh^Fds, Mm, Mm, Mm, Mm^Vhh, Mm, Hh, Hh^Fds, Mm, Mm
Gll^Fp, Gs^Fp, Gs^Fp, Gg, Gs, Gs, Gs, Gs, Gs, Gll, Gll, Hh, Gll^Fp, Gs, Hh, Mm, Mm, Mm, Mm, Mm, Hh, Gs, Mm, Hh, Mm, Mm, Hh, Gs, Hh, Hh^Fds, Gs, Mm, Mm, Hh^Fds, Hh, Gs, Hh, Mm, Mm, Mm, Mm, Hh, Gs, Hh, Mm, Mm
Gs^Fp, Gll^Fp, Hh, Gs, Gs, Hh, Gs, Hh, Mm, Hh, Mm, Hh, Hh, Gll, Gs, Mm, Mm, Mm, Hh, Hh, Gd^Vhr, Gs, Hh, Mm, Mm, Mm, Hh, Gs, Hh, Gs, Hh, Wwf, Wwrg, Wwrg, Hh, Hh, Hh, Hh, Mm, Mm, Hh, Hh, Gd, Hh, Hh, Mm
Gg, Gs^Fp, Gs, Hh, Hh, Gs, Gg, Hh, Mm, Mm, Mm, Hh, Hh, Hh, Hh, Hh, Hh, Hh, Gs, Hhd, Hhd, Gd, Hh, Hh, Mm, Mm, Hh, Hh, Mm, Mm, Mm, Hh, Wwf, Wwg^Vm, Wwg, Gs^Fds, Gs, Hh, Hh, Hh, Hh, Gs, Gs, Hh, Hh^Fds, Hh
Hh, Gg, Hh, Gll, Gll^Fp, Gs, Hh, Mm, Mm, Mm, Hh, Hh, Gs^Fms, Gs^Fms, Hh^Fms, Hh, Mm, Gg, Gs, Mm, Mm, Gs, Gg, Hh, Hh, Gs, Mm, Mm, Mm, Mm, Mm, Hh, Gg^Fds, Wwrg, Wwrg, Gg^Fds, Gg, Hh, Hh, Gg, Hh^Fds, Hh^Fds, Hh, Hh, Gg^Fds, Hh^Fds
Gs, Gs, Hh, Hh, Hh^Fp, Hh^Fp, Gs, Hh, Hh, Hh, Gg, Gg, Hh^Fms, Hh^Fms, Mm, Mm, Mm, Mm, Hh, Mm, Mm, Hh, Hh, Mm, Mm, Gg, Gg^Fds, Mm, Mm, Mm, Mm, Mm, Hh, Gg^Fds, Mm, Wwg, Gg^Fds, Hh^Fds, Hh, Hh, Mm, Hh^Fds, Hh^Fds, Gs, Gg, Hh
Gs, Hh, Hh, Hh, Hh, Hh, Hh, Gs, Hh, Hh, Hh, Gs, Hh, Hh, Mm, Mm, Gs, Mm, Hh, Hh, Mm, Mm, Mm, Mm, Hh, Hh^Fds, Hh^Fds, Hh^Fds, Hh, Mm, Gs, Mm, Hh, Hh, Mm, Mm, Hh, Hh^Fds, Mm, Mm, Mm, Mm, Mm, Hh, Hh, Hh
