Mm, Mm, Mm, Mm, Mm, Mm, Mm, Mm, Mm, Mm, Mm, Hhd, Hhd, Hhd, Mm, Mm, Mm, Mm, Gd, Gd, Gd, Hhd, Hhd, Hhd, Mm, Mm, Mm, Mm, Mm, Mm, Hh, Hh, Gs^Fms, Gd, Gd, Mm, Mm, Mm, Mm, Mm, Hhd, Hhd
Mm, Mm, Mm, Mm, Mm, Mm, Mm, Hhd, Hhd, Mm, Mm, Mm, Hhd, Hhd, Mm, Mm, Mm, Mm, Gd, Mm, Hh^Fms, Gd, Mm, Mm, Mm, Mm, Mm, Mm, Ch, Mm, Hh, Gs^Fms, Gs^Fms, Gd, Mm, Mm, Mm, Mm, Mm^Vd, Mm, Hhd, Hhd
Hh, Hh^Fms, Mm, Mm, Hhd, Mm, Mm, Hhd, Mm, Mm, Mm, Mm, Mm, Mm, Mm, Mm, Hhd, Hhd, Gd, Gd, Gd^Fms, Gs^Fms, Mm, Mm, Mm, Hhd, Mm, Hhd, Hhd, Hhd, Mm, Hh, Gs^Fms, Gd^Fmw, Mm, Mm, Hhd, Mm, Mm, Mm, Mm, Mm
Hh, Mm, Mm^Vd, Hhd^Fdw, Mv, Hhd, Mm, Mm, Mm, Mm, Mm, Hhd, Hhd, Mm, Mm, Mm, Hhd, Hhd, Cte, Gs, Gs, Gs^Fms, Hh, Mm, Mm, Hhd, Hhd, Mm, Mm, Mm, Mm, Hhd, Gd^Fmw, Gd^Fmw, Mm, Mm, Hhd, Mm, Hhd, Hhd, Mm, Mm
Mm, Mm, Mm, Mm, Mm, Mm, Mm, Mm, Qlf, Hhd, Mm, Mm, Mm, Hhd, Hhd, Mm, Mm, Cte, Kte, Cte, Gd, Gd, Hhd, Hhd, Mm^Vd, Mm, Mm, Mm, Hhd, Mm, Mm, Gd, Hhd, Hhd, Mm, Hhd, Mm, Mm, Hhd, Ch, Mm, Mm
Hh, Mm, Mm, Mm, Mm, Qlf, Qlf, Qlf, Hhd^Fdw, Hhd, Mm, Mm, Hhd, Hhd, Mm, Mm, Hhd, Cte, Cte, Cte, Gd, Gd, Gd, Mm, Mm, Mm, Hhd, Hhd, Mm, Mm, Mm, Hhd, Mm, Mm, Mm, Mm, Mm, Mm, Mm, Mm, Hhd, Mm
Hhd, Hh^Fms, Hh, Mm, Mm, Qlf, Hhd, Mm, Mm, Mm, Mm, Mm^Vd, Mm, Mm, Mm, Mm, Mm, Mm, Hhd, Gd, Gd, Hhd, Gd, Mm, Mm, Hhd, Mm, Hhd, Mm, Mm, Mm, Mm, Mm, Mm, Hhd, Mm, Mm, Mm, Mm, Hhd, Mm, Mm
Mm, Hh^Fms, Hh, Mm, Qlf, Qlf, Ch, Mm, Mm, Mm, Mm, Mm, Hhd, Mm, Mm, Mm, Mm, Mm, Hhd, Hhd, Gd, Gd, Gs, Gd, Mm, Mm, Mm, Mm, Mm, Mm, Mm, Mm, Mm, Mm, Hhd, Hhd, Hhd, Mm, Mm^Vd, Mm, Mm, Mm
Mm, Mm, Mm, Mm, Mm, Mm, Mm, Mm, Hhd, Hhd, Mm, Hhd, Hhd, Mm, Mm, Mm, Mm, Mm, Hhd, Hhd, Gd, Hhd, Mm, Gd, Hhd, Mm, Mm, Hhd, Hhd, Hhd, Mm^Vd, Mm, Mm, Mm, Mm, Hhd, Hhd, Mm, Mm, Hhd, Hhd, Mm
Gs, Mm, Mm, Mm, Hhd, Hhd, Mm, Mm, Hhd, Hhd, Mm, Mm, Mm, Mm, Mm, Hhd, Hhd, Mm, Mm, Mm, Gs, Gd, Mm, Gd, Hhd, Hhd, Mm, Mm, Hhd, Hhd, Mm, Mm, Hhd^Fmw, Hhd, Mm, Mm, Mm, Mm, Mm, Hhd, Hhd, Mm
Gs, Gs^Fms, Gd, Hh, Hh, Hhd, Mm, Mm, Mm, Hhd, Mm, Mm, Mm, Mm, Mm, Hhd, Hhd, Mm, Mm, Mm, Gd, Hhd, Gd, Gd, Hhd, Hhd, Mm, Mm, Mm, Mm, Mm, Mm, Hhd^Fdw, Hhd, Ch, Qlf, Hhd, Mm, Mm, Mm, Hhd, Mm
Gs, Hh^Fms, Gs^Fms, Gs^Fms, Gd, Mm, Mm, Mm, Mm, Mm, Mm, Mm, Mm, Hhd, Mm, Mm, Mm, Hh, Mm, Mm, Gs^Fms, Gd, Gd, Gd, Gd, Hh, Mm, Mm, Hhd, Hhd, Mm, Mm, Qlf, Hhd, Qlf, Qlf, Hhd, Hhd, Mm, Mm, Mm, Mm
Gs, Gs, Mm, Gs^Fms, Gs^Fms, Mm, Mm, Mm^Vd, Mm, Mm, Mm, Mm, Mm, Hhd, Hhd, Mm, Mm^Vd, Mm, Mm, Hh, Hh, Gs, Gd, Hhd, Gd, Gs, Mm, Mm, Mm, Hhd, Mm, Mm, Mm, Qlf, Mm, Hhd, Hhd, Hhd, Mm, Mm, Hhd, Mm
Mm, Mm, Mm, Hh, Mm, Gd, Mm, Mm, Mm, Mm, Mm, Mm, Mm, Hhd, Hh, Mm, Mm, Mm, Mm, Mm, Hh, Mm, Gd, Hhd, Mm, Gs, Gd, Mm, Mm, Mm, Mm, Mm, Qlf, Qlf, Hhd, Mm, Mm, Mm, Mm, Mm, Hhd, Hhd
Mm, Mm, Mm, Hhd, Mm, Hhd, Hhd, Mm, Mm, Hhd, Hhd, Mm, Mm, Hh, Mm, Mm, Mm, Mm, Mm, Mm, Mm, Mm, Hh, Gd, Gd, Gd, Gd, Mm, Mm, Hhd, Mm, Mm, Mv, Mm, Hhd, Mm, Mm, Mm^Vd, Mm, Mm, Hhd, Hhd
Mm, Mm, Mm, Mm, Mm, Mm, Mm, Hh, Mm, Hh, Mm, Mm, Mm, Mm, Mm, Mm, Hh, Hh, Mm, Mm, Mm, Mm, Hh, Gd, Gd, Gd, Gd, Gs^Fms, Gs, Hh, Hh, Mm, Mm, Mm, Hhd, Hhd, Mm, Mm, Hhd, Mm, Mm, Mm
Mm, Hhd, Hh, Mm, Mm, Mm, Mm, Mm, Ch, Mm, Mm, Mm, Hh, Mm, Mm, Mm, Hh, Hh, Gd, Mm, Gd, Mm, Gs, Gs, Gd, Gd, Hhd, Gd, Gd, Gs, Hhd, Mm, Qlf, Mm, Mm, Mm, Mm, Hhd, Hhd, Mm, Mm, Mm
Mm, Hh, Mm, Mm, Hh, Hh, Mm, Mm, Hh, Hh, Mm, Mm, Hh, Hh, Mm, Mm, Gs, Gd, Gd, Gd, Hh, Gd, Gd, Gd, Hhd, Mm, Mm^Vd, Hhd, Gd, Gd, Mm, Mm, Qlf, Hhd, Mm, Mm, Ch, Hhd, Hhd, Mm, Mm, Mm
Mm, Mm, Mm, Mm, Mm, Hh, Mm, Mm, Hh, Hh, Mm, Mm, Mm, Hh, Mm, Gs, Gs, Mm, Gd, Gd, Gs, Gd, Gd, Hhd, Hhd, Mm, Mm, Mm, Gd, Gd, Mm, Mm, Qlf, Mm, Hhd, Ch, Kh, Ch, Mm, Mm, Mm, Mm
Mm, Hh, Hh, Mm, Mm^Vd, Mm, Mm, Mm, Hh, Hh, Mm, Mm, Mm, Mm, Mm, Gd, Gd^Fms, Gs, Mm, Mm, Mm, Gd, Gd, Gs, Gs, Gd, Gd, Hhd, Gd, Gd, Gd, Mm, Mm, Qlf, Hhd, Ch, Ch, Ch, Mm, Mm^Vd, Mm, Mm
Mm, Hh, Hh, Mm, Mm, Mm, Mm, Hh, Mm, Mm, Mm, Mm, Hh, Mm, Hh, Gd, Gs, Gs, Mm, Mm, Mm, Hh, Hhd, Gd, Gs^Fms, Gd, Gd, Gd, Gd, Gd, Gd, Hhd, Hhd, Mm, Mm, Hhd, Mm, Hhd, Hhd, Hhd, Mm, Mm
Mm, Hh, Mm, Mm, Mm, Mm, Mm, Mm, Mm, Mm, Mm, Hh, Hh, Hh, Gs, Gs, Gs, Gd, Hh, Mm, Mm, Mm, Hhd, Hhd, Mm, Mm, Mm, Gd, Gs, Hhd, Gd, Hhd, Hhd, Mm, Qlf, Mm, Qlf, Mm, Mv, Hhd, Hhd, Hhd
Mm, Hh, Mm, Mm, Hh, Hh, Mm, Mm, Mm, Mm, Mm, Gs, Gs, Gd, Hh, Hh, Gd, Mm, Mm, Hhd, Hhd, Mm, Hhd, Mm, Mm, Mm, Mm, Gd, Gd, Gd, Gd, Gd, Gd, Mm, Mm, Qlf, Hhd^Fdw, Mm, Mm, Mm, Hhd, Hhd
Mm, Mm, Mm, Hh, Hh, Hh, Mm, Mm, Hh, Hh, Gd, Gs, Gs, Gs, Gs, Gd, Hh, Mm, Mm, Mm, Mm, Mm, Mm, Mm, Mm, Mm, Hhd, Gd, Gd, Hhd, Hhd, Gd, Gd, Gd, Gd, Hhd, Hhd, Mm, Mm, Qlf, Mm, Mm
Mm, Mm, Mm, Mm, Mm, Mm, Mm, Mm, Hh, Gs, Gd, Gd, Mm, Gd, Mm, Gd, Hh, Hh, Mm, Mm, Mm, Mm^Vd, Mm, Mm, Mm, Mm, Hhd, Gs, Gd, Gd, Hhd, Mm, Gs, Gd, Gd, Gs, Hhd, Mm, Mm, Qlf, Qlf, Mm
Hh, Hh, Mm, Mm, Hh, Mm, Mm, Mm, Gs, Gs, Gs, Mm, Mm, Mm, Hh, Mm, Mm, Hh, Mm, Mm, Mm, Mm, Hhd, Mm, Mm, Mm, Mm, Gd^Fmw, Gd, Gd, Gd, Hhd, Gd, Gd, Gd, Gd, Gd, Mm, Gd, Mm, Mm, Qlf
Hh, Hh, Mm, Mm, Hh, Mm, Gs, Gs, Gd, Gs, Hh, Hh, Mm, Mm, Hh, Hh, Mm, Mm, Mm, Mm, Hh, Hh, Hhd, Hhd, Mm, Mm, Mm, Mm, Hhd, Gs, Gs, Gd, Gd, Gd, Hhd^Fmw, Gd^Fmw, Gd, Gd, Hhd, Gd, Gd, Hhd
Mm, Mm, Mm, Hh, Co, Co, Co, Gd, Gs, Hh, Hh, Mm, Mm, Hh, Mm, Hh, Mm, Mm, Ch, Mm, Mm, Mm, Mm, Mm, Mm, Mm, Mm, Mm, Hhd, Hhd, Mm, Gd^Fmw, Hhd, Gd, Gs, Gs^Fmw, Gd, Gd, Gd, Hhd, Gd, Gd
Mm, Mm, Gs, Gs, Co, Ko, Co, Gd, Mm, Hh, Mm, Mm, Mm, Mm, Mm, Mm, Hh, Hh, Gs^Fms, Gs^Fms, Ww, Mm, Hhd, Mm, Hhd, Hhd, Mm, Mm, Mm, Hhd, Mm, Mm, Mm, Hhd, Hhd, Gd, Mm, Mm, Hhd, Gd, Hhd, Hhd
Gd^Fms, Gs, Gs, Gd, Gs, Co, Mm, Mm, Mm, Mm, Mm, Mm, Mm, Mm^Vd, Mm, Mm, Hh, Hh, Mm, Wwr, Ww, Ww, Wwr, Hhd, Hhd, Hhd, Mm, Mm, Mm, Mm, Mm^Vd, Mm, Mm, Hhd, Mm, Mm, Mm, Mm, Hhd, Hhd, Hhd, Mm
Hhd, Hh, Gs^Fms, Gs^Fms, Gs, Hh, Hh, Hh, Mm, Mm, Hh, Hh, Hh, Mm, Mm, Mm, Hh, Mm, Mm, Wwr, Gs^Fms, Wwr, Mm, Ww, Mm, Mm, Mm, Mm, Hhd, Mm, Mm, Mm, Hhd, Hhd, Mm, Hhd^Fmw, Hhd, Mm, Mm, Hhd, Mm, Mm
Hhd, Mm, Gs^Fms, Gs^Fms, Gs, Hh, Mm, Mm, Mm, Mm, Mm, Hh, Hh, Mm, Mm, Mm, Mm, Mm, Mm, Mm, Mm, Mm, Mm, Mm, Mm, Mm, Mm, Mm, Hhd, Hhd, Mm, Mm, Mm, Mm, Mm, Hhd^Fmw, Hhd, Hhd, Mm, Mm, Mm, Mm
