Xue, Xue, Uh^Crys, Uh^Crys, Re, Uue^Br|, Re, Re, Qxe, Qxe, Qxe, Qxe, Qxe, Qxe, Qxe, Qxe, Qxe, Qxe, Qxe, Qxe, Qxe, Qxe, Qxe, Qxe, Qxe, Qxe, Xue, Xue, Xue, Xue, Xue, Xue, Xue, Xue
Xue, Uh^Crys, Uh^Crys, Uue^Br\, Uue^Br\, Uue^Br|, Uue, Re, Re, Qxe, Uh, Qxe, Uh, Qxe, Uh, Uh, Re, Re, Uue, Qxe, Uue, Re, Re, Qxe, Qxe, Xue, Xue, Xue, Xue, Xue, Xue, Xue, Xue, Xue
Xue, Uh^Crys, Re, Re, Re, Uue^Br|, Cud, Re, Uue, Qxe, Qxe, Uh, Uue, Qxe, Qxe, Qxe, Qxe, Re, Qxe, Qxe, Qxe, Re, Uh, Uh, Qxe, Uh, Re, Re, Xue, Xue, Uh, Xue, Xue, Xue
Xue, Re, Uue, Uh, Cud, Kud, Cud, Re, Re, Uue, Qxe, Re, Re, Re, Qxe, Re, Re, Re^Pr|, Uue, Re, Re, Re^Pr\, Uh, Qxe, Uh, Uh, Uue, Uue, Re, Uue, Uue, Uh, Xue, Xue
Xue, Re, Uue^Vud, Re, Re, Cud, Uue, Uh, Re, Uue, Re, Qxe, Qxe, Re^Pr/, Re, Uue, Uue, Re, Re, Uue, Re, Qxe, Qxe, Qxe, Re, Uh, Re, Uue, Uh, Re, Re, Re, Xue, Xue
Xue, Re, Re, Uue, Re, Uue^Br|, Re, Re, Re, Re, Uue, Re, Qxe, Qxe, Re, Uue, Qxe, Qxe, Re^Pr|, Qxe, Qxe, Qxe, Re, Qxe, Qxe, Re, Re, Re, Re, Uh, Uue, Re^Ebn, Uh, Xue
Xue, Uh^Crys, Uh^Crys, Re, Re^Br/, Uue^Br|, Re, Xue, Uh, Re, Qxe, Qxe, Uh, Qxe, Qxe, Qxe, Uue, Qxe, Re, Qxe, Qxe, Re, Qxe, Qxe, Qxe, Re^Pr|, Qlf, Uue, Uue, Uh, Re, Re, Uh, Xue
Xue, Uh^Crys, Uue^Br/, Uue^Br/, Uue, Re^Br|, Uh, Uh, Re, Re, Qxe, Uh, Re, Uue, Uue, Uue, Re, Re, Uue, Re, Qxe, Qxe, Uh, Qxe, Qxe, Re, Qlf, Uue, Uue, Re, Re, Re^Ebn, Qlf, Xue
Xue, Uh^Crys, Uh^Crys, Re, Re, Uue^Br|, Uh, Uue, Re, Uue, Qxe, Re, Re, Uue, Re, Re, Cud, Re, Uue, Uue, Qxe, Qxe, Uue, Uue, Uue, Re, Re, Qlf, Qlf, Uue, Qlf, Qlf, Xue, Xue
Xue, Xue, Uh^Crys, Re, Uue, Uue^Br|, Xue, Uh, Re, Uue, Uue, Re^Pr\, Qxe, Re, Re, Cud, Kud, Re, Re, Re, Qxe, Uh, Uh, Re, Re, Re, Uh, Re, Qlf, Qlf, Qlf, Xue, Xue, Xue
Xue, Uue^Uf, Uue^Uf, Uue, Re, Re^Br|, Uh, Xue, Re, Uh, Re, Re, Re, Qxe, Uue, Re, Re, Re, Qxe, Re^Pr/, Re, Uh, Re, Re, Qlf, Uh, Uue, Re, Uh, Qlf, Qlf, Xue, Xue, Xue
Wog, Uue^Uf, Wog, Uue^Uf, Re, Uue^Br|, Uue^Br\, Uue, Re, Re, Re, Re, Qxe, Qxe, Uue, Re, Uh, Qxe, Re, Re, Qlf, Re, Re, Uue, Uue, Qlf, Uue, Uue, Uh, Qlf, Qlf, Qlf, Qlf, Xue
Xue, Wog, Uue^Uf, Wog, Wog, Uue^Br|, Re, Uue^Br\, Uue^Br\, Uh^Crys, Uh^Crys, Uh^Crys, Qxe, Re, Re, Re, Qxe, Qxe, Re, Uh, Uh, Uue, Re, Uue^Vud, Uue, Qlf, Re, Re, Uh, Uh, Re, Qlf, Qlf, Xue
Xue, Uue^Uf, Re, Wog, Uue^Br/, Re^Br|, Uue^Vud, Re, Uh^Crys, Uh^Crys, Xue, Xue, Re, Re^Pr\, Qxe, Qxe, Uue, Uue, Re, Re, Qlf, Uue, Qlf, Re, Re, Re, Uh, Re, Cud, Cud, Uue, Qlf, Qlf, Xue
Xue, Uh^Crys, Uue^Br/, Uue^Br/, Re, Re, Uue, Uh^Crys, Xue, Xue, Uh^Crys, Uh^Crys, Re, Re, Xue, Uh^Crys, Uh^Crys, Uh^Crys, Uue^Br\, Uue, Re, Qlf, Uh, Qlf, Uue, Uh, Re, Re, Cud, Kud, Uue, Uh, Qlf, Xue
Xue, Uh^Crys, Uh^Crys, Uh^Crys, Uh^Crys, Re, Re, Re, Xue, Uh^Crys, Re^Br\, Re, Re, Uh^Crys, Uh^Crys, Xue, Xue, Uh^Crys, Uh^Crys, Uue^Br\, Uue^Br\, Uue, Uh, Uue, Uue, Re, Uue^Br/, Uue^Br/, Uue, Cud, Uue, Uh, Qlf, Xue
Xue, Uh^Crys, Xue, Xue, Xue, Xue, Xue, Xue, Re, Uh^Crys, Uue^Br/, Uue^Br\, Re^Br\, Uue, Uue^Br/, Uh^Crys, Uh^Crys, Xue, Xue, Uue, Re, Re^Br\, Uue^Br\, Re, Re^Br/, Uue^Br/, Re, Re, Re, Re, Qlf, Qlf, Qlf, Xue
Xue, Xue, Uh^Crys, Uh^Crys, Uue, Uue, Uh, Re, Re^Br/, Uue^Br/, Uh, Uh, Uue, Uue^Br/, Re, Uh^Crys, Re, Re, Xue, Uue, Re, Qlf, Uue^Br/, Uue^Br/, Re, Uue, Uh, Uh, Xue, Xue, Xue, Qlf, Xue, Xue
Xue, Uh^Crys, Re^Br\, Uh^Crys, Re, Re, Uue^Br/, Uue^Br/, Re, Uue, Re, Re, Uue, Uh, Uue^Uf, Uue^Uf, Uue^Uf, Uue, Xue, Re, Uh^Crys, Re^Br/, Re, Uue, Xue, Xue, Xue, Xue, Uue, Uue, Re, Xue, Xue, Xue
Xue, Uh^Crys, Uue, Re^Br\, Uue^Br\, Uue^Br/, Uh, Uh, Uue, Uue^Uf, Uue^Uf, Uue^Uf, Wog, Re, Wog, Uue^Uf, Wog, Uue^Uf, Xue, Uh^Crys, Uh^Crys, Uue^Br|, Uh^Crys, Xue, Uh^Crys, Uh^Crys, Re, Re, Uh^Crys, Uue, Re^Vud, Re, Uue, Xue
Xue, Uh^Crys, Uue, Re, Re, Re, Uue^Uf, Uh, Wog, Uue^Uf, Wog, Wog, Uue^Uf, Wog, Uue^Uf, Wog, Xue, Xue, Uh, Xue, Xue, Uh^Crys, Uh^Crys, Xue, Uue, Uue, Re, Uh^Crys, Uh^Crys, Re, Re^Ebn, Uue, Uh^Crys, Xue
Xue, Uue^Uf, Wog, Wog^Bs|, Wog, Uue^Uf, Wog, Wog, Uue^Uf, Wog, Re, Uue, Re, Uue^Uf, Uue^Uf, Wog, Xue, Uh, Re, Uue, Uue, Xue, Xue, Xue, Xue, Re, Uue, Re, Re, Re, Uh^Crys, Uue, Uh^Crys, Xue
Wog, Wog, Uue^Uf, Re, Uue, Wog, Uue^Uf, Uue^Uf, Uue^Uf, Uue^Uf, Uh, Re, Xue, Uue^Uf, Re, Xue, Re, Uue, Re, Uh, Uh, Re, Re, Uh, Uh, Xue, Xue, Uue, Xue, Re, Xue, Uh^Crys, Xue, Xue
Xue, Uue^Uf, Uue^Uf, Uue^Br|, Re, Re, Re, Uue^Vud, Re, Re, Uue, Uue, Uh, Uh, Re, Xue, Re^Pr\, Re, Uue, Re, Re, Uue, Uue, Re, Uue, Xue, Xue, Xue, Uh^Crys, Xue, Uh^Crys, Xue, Xue, Xue
Xue, Uue^Uf, Uh, Uue^Br|, Re, Uh, Uue, Re, Uh, Uh, Xue, Re, Re, Re, Uh, Re, Re, Xue, Xue, Xue, Xue, Uue, Uh, Re, Re, Uue, Xue, Uh^Crys, Uh^Crys, Uh^Crys, Uue, Uh^Crys, Uh^Crys, Xue
Xue, Uh, Re, Uue^Br|, Re, Uue, Xue, Xue, Xue, Xue, Uh, Uh, Re, Re, Uh, Uue, Uue, Uue, Re, Xue, Xue, Xue, Uh, Uue, Re, Uh, Xue, Uh^Crys, Re, Re^Br|, Re, Uue^Vud, Uue, Xue
Xue, Uh, Re, Cud, Cud, Uh, Uue, Uue, Re, Uue, Re, Re, Uue, Uue, Re, Re, Xue, Uue, Xue, Xue, Xue, Xue, Xue, Re, Uh, Uh, Uh, Xue, Re, Uue^Br|, Uue^Br\, Re, Uue, Xue
Xue, Re, Uue, Kud, Cud, Uh, Re, Uh, Re, Uue, Re, Uue, Uh, Uue, Xue, Xue, Uh, Xue, Uue, Uh, Uh, Uue, Uue, Xue, Re, Uue, Re, Xue, Uh, Uh, Re, Uue^Br|, Uh, Xue
Xue, Uue, Re, Uue^Br|, Re, Uue, Uue, Re, Uue, Uh, Xue, Uh, Xue, Uh, Xue, Uue, Re, Re, Re, Re, Re, Cud, Uh, Re, Uue, Re, Uh, Xue, Xue, Uh, Uue, Re^Br|, Re, Xue
Xue, Uh^Crys, Re, Uue^Br|, Re, Xue, Re, Re, Xue, Xue, Uh, Xue, Uue, Xue, Uh, Re, Uh, Uue, Xue, Uue, Uh, Re, Uue, Uh, Cud, Cud, Re, Uue, Re, Xue, Uue^Br/, Uue^Br|, Uh, Xue
Xue, Uh^Crys, Uh^Crys, Re^Br/, Uh^Crys, Uh^Crys, Uh^Crys, Re, Xue, Uue, Uue, Uh, Uue, Re, Re, Uh, Xue, Xue, Uue, Re, Re, Re, Uh, Re, Cud, Kud, Uue^Br\, Uue^Vud, Uue^Br/, Uue^Br/, Re, Uh, Uh, Xue
Xue, Xue, Uh^Crys, Uh^Crys, Xue, Xue, Xue, Xue, Re, Uue, Uue, Re, Re, Re, Uue, Uue, Xue, Uue, Uh, Re, Uue, Cud, Uue, Uue, Re, Uue, Re^Br/, Uue^Br/, Uh, Re, Uue, Re, Wog, Xue
Xue, Xue, Xue, Xue, Uh, Uh, Re, Re, Uh, Re, Xue, Uue, Xue, Xue, Xue, Xue, Re, Uue, Uue, Re, Re, Uh, Xue, Re, Uue^Br|, Uue^Br/, Re, Re, Uh, Re, Uue^Uf, Uue^Uf, Wog, Xue
Xue, Xue, Xue, Uue, Uue, Re, Uue, Uue, Xue, Xue, Uh, Xue, Uue, Uh, Re, Uh, Uh, Re, Uue, Re, Uh, Uh, Xue, Uh, Uue^Br|, Uue, Uue, Re, Uue, Uue^Uf, Uue^Uf, Wog, Xue, Xue
Xue, Xue, Uh, Uue, Re, Re, Re, Xue, Re, Re, Re, Re, Re, Uue, Re, Re, Uh, Re, Uue, Uue, Xue, Xue, Uue, Uh, Re^Br|, Re, Re, Uue^Uf, Wog, Uue^Uf, Wog, Wog, Xue, Xue
Xue, Uh, Ce, Ce, Ce, Re^Vct, Re, Re, Re, Uue, Uue, Uh, Uue, Uue, Xue, Xue, Xue, Xue, Xue, Xue, Xue, Uh, Uue, Uue, Uue^Br|, Re, Uue, Uue^Uf, Uue^Uf, Wog, Xue, Xue, Xue, Xue
Uue, Uh, Ce, Ke, Ce, Re, Xue, Uh, Xue, Uue, Xue, Xue, Xue, Xue, Xue, Uh^Crys, Uh^Crys, Uh^Crys, Uh^Crys, Xue, Xue, Uh, Re, Re, Uue^Br/, Uh, Uue^Uf, Uue^Uf, Wog, Wog, Xue, Xue, Xue, Xue
Uue, Uue, Uh, Ce, Uue, Uue, Xue, Xue, Xue, Xue, Xue, Xue, Xue, Xue, Uh^Crys, Uh^Crys, Re, Uue^Br\, Uue^Br\, Re, Uue, Uue, Uue^Br/, Re^Br/, Uue, Uh, Xue, Xue, Xue, Xue, Xue, Xue, Xue, Xue
Xue, Uh, Xue, Uh, Xue, Xue, Xue, Xue, Xue, Xue, Xue, Xue, Xue, Xue, Uh^Crys, Uue^Vud, Uue, Re, Uue, Re^Br\, Uue^Br\, Uue^Br/, Re, Re, Uh, Uh, Xue, Xue, Xue, Xue, Xue, Xue, Xue, Xue
Xue, Xue, Xue, Xue, Xue, Xue, Xue, Xue, Xue, Xue, Xue, Xue, Xue, Xue, Xue, Xue, Xue, Xue, Xue, Xue, Xue, Xue, Xue, Xue, Xue, Xue, Xue, Xue, Xue, Xue, Xue, Xue, Xue, Xue
