Xue, Xue, Xue, Xue, Xue, Xue, Xue, Xue, Xue, Xue, Xue, Xue, Xue, Re, Re, Uue, Uue, Xue, Xue, Xue, Xue, Xue, Xue, Xue, Xue, Xue, Qlf, Xue, Xue, Xue, Xue, Xue, Xue, Xue, Xue, Xos, Xos, Xos, Xos, Xos, Xos, Xos, Xos, Xos, Xos, Qlf, Qlf, Qlf, Qlf, Qlf, Qlf, Qlf, Re, Uue, Uue^Br/, Uue^Br/
Xue, Xue, Xue, Xue, Xue, Xue, Xue, Xue, Xue, Xue, Xue, Xue, Uh, Uh, Re, Re, Uue, Xue, Xue, Xue, Xue, Xue, Xue, Xue, Xue, Xue, Xue, Qlf, Xue, Xue, Xue, Xue, Re, Xue, Uh, Xos, Uu, Ur, Ur, Uu, Uu, Uu, Uu, Ur, Cud, Cud, Ur, Qlf, Ur, Qlf, Cud, Qlf, Re^Br/, Re^Br/, Uue, Uue
Xue, Xue, Xue, Xue, Xue, Xue, Xue, Xue, Xue, Xue, Xue, Xue, Xue, Uh, Uh, Re, Re, Xue, Xue, Uh, Uh, Xue, Xue, Xue, Xue, Xue, Qlf, Qlf, Xue, Xue, Xue, Re, Re, Uh, Uh, Xos, Uu, Uu, Cud, Ur, Uu, Ur^Ebn, Uu, Ur, Ur, Xos^Efs, Uu, Uu, Uu^Vud, Ur, Xos^Efs, Cud, Cud, Uue, Qlf, Qlf
Xue, Xue, Xue, Xue, Xue, Xue, Xue, Xue, Xue, Xue, Xue, Xue, Xue, Uue, Uue, Uue, Re^Xo, Re^Xo, Re, Uh, Uh, Uue, Uue, Xue, Uh, Xue, Qlf, Qlf, Xue, Xue, Uue, Uh, Re, Re, Re, Xos, Uu, Uu, Ur, Ur, Uu, Uu, Ur, Uu, Uu, Uu, Urc, Urc, Urc, Uu, Uu, Ur, Qlf, Qlf, Qlf, Qlf
Xue, Xue, Xue, Xue, Xue, Xue, Xue, Xue, Xue, Xue, Xue, Xue, Uh, Xue, Xue, Uue^Xo, Uue, Uue, Uue, Re, Re, Re, Re, Uue, Uh, Qlf, Qlf, Qlf, Xue, Xue, Re, Uue, Re, Uue, Uue, Cud, Uu, Ur, Xos^Efs, Uu, Uu, Ur, Cud, Ur, Uu, Urc, Cud, Cud, Cud, Urc, Uu, Ur, Cud, Qlf, Uu, Qlf
Xue, Xue, Xue, Xue, Xue, Xue, Xue, Xue, Xue, Uh, Uh, Uh, Re, Uh, Re, Uue, Uue, Uue, Xue, Uue, Uue, Uue, Re, Uue, Uh, Qlf, Qlf, Qlf, Uh, Uh, Uue, Re, Uue, Re, Uh, Cud^Ebn, Uu, Uu, Ur, Uu, Uu, Ur, Cud, Xos^Efs, Uu, Urc, Cud, Kud, Cud, Urc, Uu, Xos^Efs, Cud, Ur, Uu, Xos
Xue, Xue, Xue, Xue, Xue, Xue, Uh, Uue, Uue, Uue, Uue, Re, Re, Re^Vud, Uue, Re, Uue, Uh, Uh, Xue, Uue, Uue, Re, Re, Re, Uh, Qlf, Qlf, Qlf, Uh, Uue, Re, Re^Vud, Uh, Uue, Cud, Uu, Ur, Cud, Ur, Uu^Vud, Ur, Ur, Ur, Uu, Urc, Urc, Cud, Urc, Urc, Uu, Ur, Ur, Ur, Uu, Xos
Xue, Xue, Xue, Xue, Xue, Uh, Uue, Re, Re, Uh, Re, Uue, Re, Uue, Re, Re, Uue, Uue, Uue, Uue, Uh, Re, Uh, Re, Uue, Re, Qlf^Bcx\, Qlf, Uue, Uue, Re, Uue, Uue, Re, Re, Ur, Uu, Uu, Cud, Ur, Uu, Uu, Uu, Uu, Ur, Uu, Uu, Urc, Uu, Uu, Ur, Uu, Uu, Uu, Uu, Xos
Xue, Xue, Xue, Xue, Uh, Uh, Uue, Uue, Re, Re, Uue, Re, Uh, Uue, Uue, Re, Re, Re, Re, Uue, Re^Vud, Re, Uue, Uh, Uue, Re, Qlf, Qlf^Bcx\, Re, Re, Re, Uue, Re, Uue, Uue, Cud, Uu, Uu, Ur, Ur, Uu, Ur^Ebn, Uu, Ur, Cud, Xos^Efs, Ur, Uu, Ur, Xos^Efs, Cud, Ur, Uu, Ur^Ebn, Uu, Xos
Xue, Xue, Xue, Xue, Xue, Uh, Uue, Re, Uue, Uue, Xue, Uue, Uh, Re, Uue, Uh, Uh, Uh, Uue, Re, Re, Re, Re, Uue, Uue, Qlf, Qlf, Qlf, Uh, Uue, Uue, Re, Uh, Re, Uh, Cud^Ebn, Uu, Ur, Xos^Efs, Uu, Ur, Uu, Uu, Ur, Ur, Cud, Ur, Uu, Ur, Cud, Ur, Ur, Uu, Uu, Uu, Xos
Xue, Xue, Xue, Xue, Uue, Uue, Re, Uh, Uh, Xue, Uh, Uue, Uue, Re, Re, Uue, Uue, Uue, Uue, Re, Uue, Uh, Uue, Re, Uh, Qlf, Qlf, Qlf, Uh, Uh, Uue, Re, Uue, Uh, Uh, Cud, Uu, Uu, Ur, Ur, Cud, Ur, Ur, Uu, Uu, Ur, Uu, Uu, Uu, Ur, Uu^Vud, Uu, Ur, Ur, Ur, Xos
Xue, Xue, Xue, Uh, Uue, Re, Re, Re, Uue, Xue, Uh, Uue, Re, Re, Uue, Re, Uue, Uue, Re, Uue, Uue, Uue, Uue, Uue, Uh, Uh, Qlf, Qlf, Qlf, Re, Re, Re, Uue, Uue, Re, Ur, Cud, Uu, Uu, Uu, Uu, Cud, Ur, Uu, Uu, Uu, Uu, Ur^Ebn, Uu, Uu, Uu, Uu, Ur, Cud, Uu, Xos
Xue, Xue, Uh, Uh, Uh, Uue, Re, Uue, Uue, Uue, Uue, Uue, Re, Re, Uh, Uue, Uue, Uh, Re, Re, Cud, Cud, Cud, Uue, Re, Uh, Qlf, Qlf, Qlf, Uue, Uh, Uue, Uh, Re, Re, Uue, Uh, Cud^Ebn, Cud, Uu, Uu, Ur, Uu, Xos^Efs, Ur, Ur, Ur, Uu, Ur, Ur, Ur, Xos^Efs, Uu, Ur, Uu, Xos
Xue, Xue, Xue, Uh, Uue, Uue, Re, Uh, Uh, Re, Uh, Uue, Uue, Uue, Uh, Xue, Uue, Re, Re, Uh, Cud, Kud, Cud, Re, Uue, Uue, Uh, Qlf, Qlf, Qlf, Uue, Uh, Re, Re^Vud, Uue, Uue, Uh, Uue, Re, Kud, Cud, Uu, Uu, Ur, Uu, Cud, Ur, Uu, Ur, Cud, Uu, Ur, Uu, Uu, Xos, Xos
Xue, Xue, Xue, Xue, Uue, Re, Uue, Re, Re, Re^Vud, Uue, Uh, Re, Uue, Re, Uh, Re, Re, Uh, Uh, Uh, Cud, Re, Re, Uue, Uue, Uue, Qlf, Qlf, Qlf, Re, Re, Uh, Uue, Re, Uh, Uue, Re, Uue, Uue, Uh, Cud^Ebn, Cud, Uu, Uu, Uu, Ur, Xos^Efs, Ur, Uu, Uu, Uu, Xos, Xos, Uh, Xue
Xue, Xue, Uh, Uh, Uh, Uh, Uue, Uue, Uue, Uue, Uue, Uh, Re, Re, Uue, Re, Re, Uue, Uue, Uue, Uue, Uue, Uue, Re, Re, Uue, Uh, Qlf, Qlf, Qlf, Qlf, Uue, Uh, Uue, Re, Re, Uue, Re, Uue, Uh, Uh, Uue, Re, Ur, Cud, Uu, Uu, Uu, Uu, Uu, Cud, Xos, Uue, Uh, Uh, Xue
Qxe, Qxe, Qxe, Uue, Re, Uh, Re, Re, Uue, Uh, Uh, Uue, Re, Uue, Uh, Re, Uue, Re, Re, Re, Uh, Uue, Uh, Uh, Re, Uh, Uh, Uue, Qlf, Qlf, Qlf, Qlf, Uh, Uh, Uue, Re, Uh, Uh, Re, Uue, Uh, Re, Re, Uue, Uh, Cud^Ebn, Cud, Uu, Cud, Cud^Ebn, Uh, Re, Re, Uue, Re, Xue
Qxe, Qxe, Uue, Uue, Uue, Re, Re, Uue, Uue, Uh, Uue, Uue, Uue, Uh, Uue, Re, Uh, Uue, Uue, Uue, Xue, Re, Re, Uue, Re^Vud, Uue, Re, Uue, Uue, Qlf, Qlf, Qlf, Qlf, Uue, Re, Re, Uue, Uue, Re, Re^Vud, Re, Uh, Uue, Uue, Re, Uue, Uue, Ur, Uue, Uh, Uue, Uh, Re, Re, Re, Xue
Qxe, Qxe, Qxe, Uue, Cer, Cer, Cer, Re, Re, Uue, Re, Uue, Xue, Uue, Uue, Re, Uue, Uue, Uue, Uh, Xue, Uh, Uue, Re, Re, Re, Uue, Uue, Uh, Uue, Uue, Qlf, Qlf^Bcx/, Qlf^Bcx/, Qlf, Uue, Qlf, Re, Uue, Re, Re, Uue, Uh, Uh, Uue, Uue, Re, Re, Uue, Uue, Re, Uue, Re, Uh, Xue, Xue
Qxe, Qxe, Uh, Uh, Cer, Ker, Cer, Uue, Uue, Re, Uue, Uue, Uh, Xue, Uue, Uue, Uue, Re, Uh, Uue, Uue, Uh, Uue, Re, Re, Uue, Uue, Uh, Uue, Uue, Re^Br/, Re, Uh, Qlf, Qlf, Qlf, Qlf, Uue, Uh, Uue, Uh, Re, Re, Re, Re, Re, Re^Vud, Re, Uh, Re, Uue, Re, Uh, Uh, Xue, Xue
Qxe, Qxe, Uh, Uh, Uue, Cer, Re, Uue, Uh, Uue, Uue, Uue, Uue, Uh, Uue, Re, Re, Re, Uh, Uue, Uue, Uue, Uue, Uue, Uh, Re, Re, Uh, Re^Br/, Re^Br/, Re, Uh, Uh, Uh, Qlf, Qlf, Qlf, Qlf, Qlf, Uh, Qlf, Uue, Re, Uue, Uh, Uh, Re, Re, Uh, Uh, Re, Re, Uue, Xue, Xue, Xue
Qxe, Uh, Uh, Uue, Uue, Re, Re, Uue, Uh, Uh, Uh, Re, Uue, Re, Re^Vud, Uue, Re, Re, Re, Uue, Re, Re, Uue, Uue, Uh, Uue, Uue, Re^Br/, Uue, Uue, Uue, Re, Re, Uue, Uue, Qlf, Qlf, Qlf, Qlf, Qlf, Qlf, Qlf, Uh, Uue, Uue, Uue, Re, Uue, Uue, Uue, Re, Uue, Xue, Xue, Qlf, Qlf
Xue, Qxe, Uh, Uue, Uue, Uue, Uue, Re, Uue, Re, Re, Re, Re, Uue, Re, Re, Re, Uue, Uue, Re, Re, Uh, Uh, Re, Re, Uh, Uue, Re^Br|, Uh, Uh, Uue, Re, Re, Uue, Uue, Uue, Uue, Uue, Uh, Qlf, Qlf, Qlf, Qlf, Uue, Qlf, Re, Uue, Re, Re, Re, Qlf, Xue, Xue, Xue, Qlf, Xue
Xue, Xue, Xue, Xue, Uue, Uh, Re, Re, Uue, Uue, Uh, Uue, Uue, Re, Uue, Uh, Uue, Re, Uue, Uue, Uue, Re, Uh, Uue, Uue, Uh, Uue^Br/, Uue^Br|, Uh, Xue, Uue, Uue, Uue, Re, Re^Vud, Uue, Uue, Uh, Uh, Uue, Uue, Qlf, Qlf, Qlf, Qlf, Uh, Uue, Re, Qlf, Uh, Qlf, Qlf, Qlf, Qlf, Xue, Xue
Xue, Xue, Xue, Xue, Xue, Uh, Uh, Uh, Uh, Uue, Uue, Uue, Uh, Re, Re, Uue, Uue, Uue, Uh, Uue, Uue, Re, Re, Uue, Uue^Br/, Re^Br/, Re, Uue, Uh, Xue, Uh, Uue, Re, Re, Uue, Re, Re, Uh, Uue, Uue, Uue, Qlf, Uh, Qlf, Qlf, Qlf, Qlf, Qlf^Bcx|, Qlf, Qlf, Qlf, Xue, Xue, Xue, Xue, Xue
Xue, Xue, Xue, Xue, Xue, Uh, Xue, Xue, Uh, Uh, Uue, Uue, Uue, Uh, Uh, Re, Uue, Uue, Uh, Xue, Uue, Re^Vud, Re^Br/, Re^Br/, Uue, Uue, Re, Uue, Uue, Uue, Uue, Uue, Re, Uue, Uue, Uue, Re, Re, Re, Uue, Uh, Uue, Uue, Uh, Uh, Qlf, Uh, Qlf^Bcx|, Uue, Qlf, Uue, Xue, Xue, Xue, Xue, Xue
Xue, Xue, Xue, Xue, Xue, Xue, Xue, Xue, Xue, Xue, Uue, Re, Re, Uh, Uh, Uue, Uh, Re, Uue, Uue, Re, Re, Re^Br|, Uue, Uh, Uh, Uue, Re, Re, Re, Re, Re, Re, Uue, Uh, Uh, Uue, Re, Cud, Cud, Cud, Uue, Uue, Uue, Uue, Uue, Re, Re, Uue, Uh, Uue, Uh, Uh, Xue, Xue, Xue
Xue, Xue, Xue, Xue, Xue, Xue, Xue, Xue, Xue, Xue, Uue, Uue, Uue, Re, Re, Uh, Uh, Re, Re, Re, Uue, Uue, Uue^Br\, Uue, Re, Uh, Uue, Uue, Uue, Uh, Uh, Uh, Uue, Re, Re, Uh, Uue, Uh, Cud, Kud, Cud, Re, Re, Uh, Re, Uue, Re, Re, Uh, Uue, Uue, Uh, Uue, Xue, Xue, Xue
Xue, Xue, Xue, Xue, Xue, Xue, Xue, Xue, Xue, Uue, Re, Uue, Uh, Uue, Re, Uue, Uue, Uue, Re, Uh, Uue, Uue, Uue, Re^Br|, Uue, Uue, Xue, Uue, Uue, Uue, Uue, Uh, Uh, Uue, Re, Re, Uue, Uue, Uh, Cud, Uue, Re, Uue, Re, Uue, Re, Re, Uue, Xue, Uh, Uue, Re, Xue, Xue, Xue, Xue
Xue, Xue, Xue, Xue, Xue, Xue, Xue, Xue, Uh, Uue, Re, Re, Uh, Uue, Re, Re, Re, Uue, Re, Uue, Uue, Uh, Re, Re^Br|, Uh, Uue, Xue, Xue, Uh, Re, Re, Re, Uue, Uue, Uue, Re, Uue, Uue, Uh, Uh, Uue, Uue, Re, Re, Uue, Re^Vud, Re, Uue, Uue, Uh, Re, Re, Xue, Xue, Xue, Xue
Xue, Xue, Xue, Xue, Xue, Xue, Xue, Uue, Uue, Uh, Uue, Uue, Uue, Uue, Re, Re, Uh, Re, Uue, Re, Uh, Uh, Uue, Re^Br|, Uue, Uue, Uue, Uh, Uue, Uh, Uue, Re, Re, Uh, Uh, Uh, Xue, Re, Uue, Uue, Uue, Re, Re, Uue, Uue, Uh, Uh, Re, Uue, Re, Re, Uue, Uue, Uh, Xue, Xue
Xue, Xue, Xue, Xue, Xue, Xue, Uh, Uue, Uue, Uue, Re, Uue, Uue, Re, Co, Uue, Uue, Re, Uue, Uue, Uue, Uh, Uue^Br|, Re^Br/, Re, Uue, Re, Re, Uue, Uue, Uue, Uue, Re^Vud, Uue, Uue, Xue, Uue, Re, Uh, Re, Re, Re, Uue, Re, Uue, Uue, Uue, Uue, Re, Uue, Re, Uue, Re^Vud, Uh, Xue, Xue
Xue, Xue, Xue, Xue, Xue, Uh, Uh, Uue, Re, Re, Uh, Re, Re, Co, Ko, Co, Re, Re, Re, Uue, Re, Re^Vud, Uue^Br/, Uh, Uue, Re, Uue, Re, Re, Re, Re, Uh, Re, Uue, Re, Uue, Uue, Uue, Uh, Re, Re, Uue, Re, Uh, Uh, Uue, Xue, Uue, Uue, Re, Uh, Re, Uue, Re, Xue, Xue
Xue, Xue, Xue, Xue, Xue, Xue, Uh, Uue, Uue, Uue, Uue, Uue, Uue, Co, Co, Co, Uue, Uue, Uue, Re, Re, Re^Br|, Uue, Uh, Uue, Uue, Uue, Uh, Uue, Uue, Uue, Re, Re, Re, Uue, Re, Re, Re, Uue, Uh, Uue, Uue, Re, Uh, Uh, Xue, Xue, Uh, Uue, Uh, Uue, Re, Uh, Xue, Xue, Xue
Xue, Xue, Xue, Xue, Xue, Xue, Xue, Xue, Uh, Uh, Uue, Uue, Re, Re, Re, Re, Uue, Uh, Uh, Uue, Uue, Re^Br|, Uue, Uh, Uh, Uue, Uue, Uh, Uue, Uue, Uh, Re, Uue, Uue, Cte, Uue, Re, Uue, Uh, Uue, Uue, Uue, Re, Uue, Uue, Uue, Uue, Uue, Uue, Uue, Uue, Uh, Xue, Xue, Xue, Xue
Xue, Xue, Xue, Xue, Xue, Xue, Xue, Xue, Uh, Uh, Uue, Re, Re, Uue, Uue, Re, Re, Uh, Uh, Uh, Uue, Re^Br|, Uue, Xue, Uue, Uue, Re, Uue, Re, Re, Re, Re, Re, Cte, Kte, Cte, Uue, Re, Re, Uue, Uh, Uh, Uue, Re, Uue, Uue, Re^Vud, Re, Re, Uh, Uh, Xue, Xue, Xue, Xue, Xue
Xue, Xue, Xue, Xue, Xue, Xue, Xue, Xue, Uh, Uue, Uue, Re, Uh, Uh, Uue, Uue, Uue, Re, Re, Uue, Re, Re^Br|, Uue^Br\, Uue, Re, Re, Uue, Re, Uue, Re, Uue, Uue, Uue, Cte, Cte, Cte, Uue, Uue, Re, Uue, Uh, Xue, Uue, Uue, Uue, Re, Uh, Uue, Re, Re, Uh, Uh, Xue, Xue, Xue, Xue
Xue, Xue, Xue, Xue, Xue, Xue, Xue, Xue, Xue, Xue, Uue, Uue, Uue, Uue, Xue, Uh, Uh, Uue, Uue, Re, Uue, Re, Re^Br|, Re, Uue, Uh, Uh, Uue, Uh, Re, Uue, Uue, Uue, Uue, Re, Re, Uue, Uue, Uh, Re, Uue, Uue, Uh, Uue, Uue, Uh, Uh, Uue, Uue, Uue, Xue, Uh, Xue, Xue, Xue, Xue
Xue, Xue, Xue, Xue, Xue, Xue, Xue, Xue, Xue, Xue, Xue, Xue, Xue, Xue, Xue, Uh, Uh, Xue, Xue, Uue, Uue, Uue, Uue^Br|, Uue, Uue, Uh, Xue, Uue, Uue, Uue, Uue, Uh, Uh, Uh, Uh, Re, Uue, Uh, Xue, Uue, Uue, Uue, Uh, Uue, Uue, Uue, Xue, Xue, Xue, Xue, Xue, Xue, Xue, Xue, Xue, Xue
Xue, Xue, Xue, Xue, Xue, Xue, Xue, Xue, Xue, Xue, Xue, Xue, Xue, Xue, Xue, Xue, Xue, Xue, Xue, Uh, Uue, Re, Re^Br|, Uue, Uue, Xue, Xue, Xue, Xue, Xue, Xue, Xue, Uh, Uh, Uh, Uue, Uue, Uh, Xue, Xue, Xue, Uh, Xue, Xue, Xue, Uh, Xue, Xue, Xue, Xue, Xue, Xue, Xue, Xue, Xue, Xue
Xue, Xue, Xue, Xue, Xue, Xue, Xue, Xue, Xue, Xue, Xue, Xue, Xue, Xue, Xue, Xue, Xue, Xue, Xue, Uue, Uue, Re, Re^Br|, Uue, Uue, Xue, Xue, Xue, Xue, Xue, Xue, Xue, Xue, Xue, Xue, Xue, Xue, Xue, Xue, Xue, Xue, Xue, Xue, Xue, Xue, Xue, Xue, Xue, Xue, Xue, Xue, Xue, Xue, Xue, Xue, Xue
